border_size=1
usage=map

Ms          , Ms          , Ms          , Ms          , Ms          , Ms          , Ms          , Ms          , Ms          , Ms          , Ms          , Ms          , Ha          , Ha          , Ha          , Ha          , Mm          , Mm          , Mm          , Mm          , Mm          , Mm          , Mm          , Mm          , Mm          , Gg          
Ms          , Ms          , Ha          , Ms          , Mm^Xm       , Ms          , Ms          , Ms          , Ms          , Ms          , Ms          , Ms          , Ha          , Ha          , Mm          , Mm          , Mm          , Mm          , Mm          , Mm          , Mm          , Mm          , Mm          , Mm          , Mm          , Mm          
Ms          , Ms          , Mm^Xm       , Mm^Xm       , Ms          , Mm^Xm       , Mm^Xm       , Ms          , Aa          , Ms          , Aa          , Aa          , Mm          , Mm          , Mm          , Mm          , Mm          , Mm          , Mm          , Mm^Xm       , Mm          , Mm          , Mm          , Mm          , Mm^Xm       , Mm          
Ms          , Mm^Xm       , Ms          , Ms          , Ai          , Ms          , Ms          , Mm^Xm       , Aa          , Aa          , Dd          , Aa          , Mm          , Mm          , Md^Xm       , Mm          , Rd          , Mm          , Mm          , Mm          , Mm          , Mm          , Mm          , Mm          , Mm          , Mm          
Mm^Xm       , Ms          , Ms          , Ms          , Aa          , Ai          , Ms          , Mm^Xm       , Ha          , Dd          , Dd          , Rd          , Rd          , Md^Xm       , Rd          , Rd          , Rd          , Rd          , Ds          , Mm          , Chr         , 5 Khr       , Chr         , Mm          , Mm          , Mm          
Ms          , Ms          , Ha          , Ha          , Aa          , Ai          , Wwf         , Mm^Xm       , Mm^Xm       , Dd          , Mm^Xm       , Dd          , Dd          , Rd          , Md^Xm       , Md^Xm       , Md^Xm       , Dd          , Rr          , Rr          , Ds          , Chr         , Ds          , Hd          , Hd          , Md^Xm       
Aa          , Ha          , Aa          , Aa          , Wo          , Wo          , Ha^Fma      , Mm          , Mm^Xm       , Mm^Xm       , Mm^Xm       , Md^Xm       , Dd          , Md^Xm       , Md^Xm       , Md^Xm       , Md^Xm       , Chr         , Dd          , Dd          , Dd          , Ds          , Ds          , Hd          , Hd          , Md^Xm       
Aa          , Aa          , Wo          , Wo          , Chr         , Chr         , Chr         , Chr         , Ms^Vhha     , Ha^Fma      , Md^Xm       , Md^Xm       , Md^Xm       , Md^Xm       , Md^Xm       , Md^Xm       , Dd          , Dd          , Dd          , Dd          , Dd          , Dd          , Ds          , Hd          , Hd          , Md^Xm       
Wo          , Wo          , Aa^Fda      , Ha^Fma      , Dd          , 4 Khr       , Dd          , Dd          , Dd          , Md^Xm       , Md^Xm       , Md^Xm       , Md^Xm       , Hd          , Hd          , Hd          , Hd          , Hd          , Dd^Do       , Dd^Vdt      , Dd          , Dd          , Ds          , Hd          , Hd          , Md^Xm       
Aa^Fda      , Ww          , Gs^Fp       , Aa^Fda      , Re          , Rp          , Dd          , Dd          , Dd          , Md^Xm       , Md^Xm       , Md^Xm       , Md^Xm       , Hd          , Dd          , Dd          , Dd          , Dd          , Dd          , Dd          , Dd          , Dd          , Ds          , Hd          , Dd^Do       , Md^Xm       
Ww          , Ww          , Gs^Fp       , Re^Vct      , Hh^Fmw      , Rd          , Dd          , Re^Vct      , Dd          , Dd          , Md^Xm       , Md^Xm       , Md^Xm       , Md^Xm       , Dd          , Dd          , Dd          , Dd          , Dd          , Ds          , Ds          , Ds          , Hd          , Dd^Vdt      , Ds          , Md^Xm       
Gs^Fp       , Gs^Fp       , Gs^Fp       , Re          , Hh          , Rd          , Dd          , Dd          , Dd          , Dd          , Md^Xm       , Md^Xm       , Md^Xm       , Md^Xm       , Dd          , Dd          , Dd          , Dd          , Ds          , Ds          , Hd          , Hd          , Ds          , Ds          , Ds          , Md^Xm       
Gs^Fp       , Gs^Fp       , Re          , Re          , Hh          , Rd          , Dd          , Dd          , Md          , Hd          , Md^Xm       , Md^Xm       , Md^Xm       , Dd          , Dd          , Dd          , Dd          , Dd          , Ds          , Hd          , Ds          , Md          , Md          , Ds          , Dd          , Md^Xm       
Gs^Fp       , Gs^Fp       , Re          , Hh          , Hh^Fmw      , Rd          , Hd          , Dd          , Hd          , Md          , Md          , Md^Xm       , Hd          , Hd          , Rd          , Dd          , Ds          , Ds          , Rd          , Rd          , Ds          , Dd          , Dd          , Md          , Dd^Dc       , Ds          
Gs^Fp       , Gs^Fp       , Hh          , Hh          , Rd          , Rd          , Rd          , Md          , Md          , Md          , Hd          , Hd          , Md^Xm       , Dd          , Dd          , Rd          , Rd          , Rd          , Md          , Md          , Md          , Md          , Md          , Dd          , Dd          , Dd^Do       
Ww          , Hh          , Ggf         , Rd          , Mm^Xm       , Mm^Xm       , Mm^Xm       , Rd          , Rd          , Rd          , Dd^Do       , Dd          , Mm^Xm       , Dd          , Dd          , Hd          , Hd          , Md          , Md          , Md          , Md          , Dd          , Md          , Md          , Md          , Md          
Hh          , Ww          , Wwf         , Mm^Xm       , Mm^Xm       , Mm^Xm       , Mm^Xm       , Mm^Xm       , Mm^Xm       , Mm^Xm       , Mm^Xm       , Mm^Xm       , Mm^Xm       , Mm^Xm       , Mm^Xm       , Hd          , Mm^Xm       , Md          , Md          , Md          , Md          , Md          , Md          , Md          , Md          , Md^Xm       
Hh          , Hh          , Wwf         , Chw         , Hh          , Hh          , Hh          , Mm^Xm       , Mm^Xm       , Mm^Xm       , Hh          , Mm^Xm       , Hh          , Mm^Xm       , Mm^Xm       , Mm^Xm       , Mm^Xm       , Mm^Xm       , Mm^Xm       , Md^Xm       , Md^Xm       , Md          , Md^Xm       , Md          , Md^Xm       , Md^Xm       
Hh          , Chw         , Wwf         , Wwf         , Hh^Fmw      , Hh          , Hh          , Hh          , Hh          , Hh          , Hh          , Hh          , Hh          , Hh^Vc       , Hh          , Hh          , Hh          , Mm^Xm       , Xu          , Xu          , Xu          , Mm^Xm       , Mm^Xm       , Md^Xm       , Mm^Xm       , Md^Xm       
Ww          , Ww          , Ggf         , Re          , Re          , Hh^Fmf      , Gs          , Hh          , Hh          , Hh          , Hh          , Hh          , Hh^Fdf      , Hh^Fdf      , Hh^Fdf      , Hh          , Hh          , Hh          , Xos         , Ur          , 3 Kud       , Xu          , Xu          , Mm^Xm       , Xu          , Mm^Xm       
Gg          , Ggf         , Gs          , Gs          , Gs          , Re          , Re          , Gs          , Gs          , Hh          , Gs          , Hh^Fmw      , Gs          , Gs          , Gs          , Hh^Fdf      , Hh^Fmw      , Hh          , Uu^Vud      , Cud         , Cud         , Cud         , Xos         , Xu          , Xu          , Xu          
Ggf         , Gs          , Gs          , Gs          , Gs          , Gs          , Gs          , Re          , Re          , Gs          , Gs          , Gs          , Gs          , Gs          , Gs          , Gs          , Hh^Fmf      , Hh^Fmf      , Hh^Fmw      , Qxu         , Qxu^Bs|     , Qxu         , Hh^Fdf      , Xu          , Xu          , Xu          
Ggf         , Gs          , Gs          , Gs          , Gs          , Gs          , Re^Gvs      , Re^Gvs      , Gs          , Re          , Re          , Re^Gvs      , Re^Gvs      , Gs          , Gs^Vht      , Gs          , Hh^Fmf      , Hh^Fmw      , Rd          , Hh^Fmw      , Hh^Fmw      , Hh^Fdf      , Hh^Fdf      , Hh          , Hh^Fdf      , Xu          
Ggf         , Ggf         , Ggf         , Gs          , Gs          , Gs^Vht      , Gs          , Gs          , Gs          , Gs          , Gs          , Re          , Gs          , Gs          , Gs          , Gs          , Gs          , Rd          , Hh^Fdf      , Hh^Fmw      , Hh^Fdf      , Hh^Fdf      , Hh^Fdf      , Hh^Fdf      , Hh^Fdf      , Ms          
Ggf         , Ggf         , Ggf         , Gs          , Gs          , Gs          , Gs          , Gs          , Gs          , Gs          , Gs          , Re          , Gs          , Gs          , Gs          , Gs          , Hh^Fmf      , Hh^Fmf      , Hh^Fdf      , Hh^Fdf      , Mm          , Hh^Fdf      , Mm          , Hh^Fdf      , Mm^Xm       , Ms          
Ggf         , Ggf         , Gs          , Gs          , Gs          , Gs          , Gs          , Gs          , Gs          , Gs          , Gs          , Re          , Re^Vct      , Gs          , Gs          , Gs^Fdw      , Gs^Fdw      , Hh^Fmf      , Hh^Fmf      , Mm          , Hh^Fmf      , Mm^Xm       , Mm^Xm       , Mm          , Mm^Xm       , Ms          
Ww          , Ggf         , Ggf         , Gs          , Gs          , Gs          , Gs          , Gs          , Gs          , Gs          , Gs^Fdw      , Re          , Re^Gvs      , Re^Gvs      , Gs          , Gs          , Gg          , Gg          , Gs^Fdw      , Hh^Fmf      , Gs          , Hh^Fmf      , Hh          , Mm          , Mm          , Mm          
Wwf         , Ww          , Ww          , Ss          , Ss          , Gs          , Gg          , Gs          , Gs^Fdw      , Gg          , Re          , Re          , Gg          , Gs          , Gs          , Gs          , Ss^Vhs      , Gs^Fdw      , Gs^Fdw      , Gs          , Gs          , Hh^Fmf      , Hh          , Hh          , Hh          , Hh          
Wwf         , Wwf         , Wwf         , Ww          , Ss          , Ss          , Ss          , Gg          , Gg          , Gs^Fdw      , Gs^Fdw      , Gs^Fdw      , Ss          , Gs^Fdw      , Gs^Fdw      , Gs^Fdw      , Ss          , Dd^Dc       , Ss          , Gs^Fdw      , Gs^Fdw      , Gs^Fdw      , Gs^Fdw      , Gs^Fdw      , Gs^Fdw      , Hh          
Ss          , Ss          , Ss          , Ss          , Ss          , Ss^Vhs      , Ss          , Ss          , Ss          , Gs^Fdw      , Ss          , Ss          , Ss          , Ss          , Ds          , Ds          , Ds          , Ss          , Ss          , Ss          , Ss          , Gs^Fdw      , Ss          , Ss          , Ss          , Gs^Fdw      
Ss          , Ss          , Ss          , Ss          , Ss          , Ss          , Ww          , Ss          , Ss          , Ss          , Ww          , Ww          , Ww          , Ww          , Ww          , Ww          , Ww          , Ww          , Ww          , Ss          , Ss          , Ss          , Chs         , Chs         , Ss^Vm       , Ss          
Ww          , Ww          , Ww          , Ww          , Ww          , Ww          , Ss          , Ww          , Ww          , Ww          , Ss          , Ss          , Ss          , Ss          , Ss          , Ss          , Ss          , Ss          , Ww          , Ss          , Ss          , Ss          , Chs         , 2 Khw       , Ss          , Ss          
Re^Gvs      , Re^Gvs      , Ss          , Ss          , Ss          , Ss          , Ss          , Ss          , Ss          , Ss          , Ss          , Ss          , Ss          , Ss          , Ss          , Ss^Vhs      , Ss          , Ss          , Ss          , Ww          , Ww          , Ss          , Ss          , Chw         , Ss          , Ss          
Ggf         , Ss          , Ss          , Ss          , Ss          , Ss          , Gg          , Ss          , Ss          , Ss          , Gg          , Gg          , Gg          , Ss          , Ss          , Ss          , Gg          , Gg          , Ss          , Ss          , Ww          , Ww          , Ww          , Chw         , Wwf         , Wwf         
Ggf         , Ggf         , Gg          , Ss          , Gg          , Gg          , Gg          , Gg          , Gg          , Gg          , Ce          , Ce          , Ce          , Gg          , Gg          , Gg          , Gg          , Gg          , Ss          , Ss          , Ww          , Ww          , Ww          , Wwf         , Wwf         , Wwf         
Ggf         , Ggf         , Gg^Vc       , Gg          , Gg          , Gg          , Gg          , Gg          , Gg          , Gg          , Ce          , 1 Ke        , Ds          , Gg          , Gg          , Gg          , Ww          , Gg          , Ww          , Ww          , Ww          , Ww^Vm       , Ww          , Wwf         , Wwf         , Wwf         
Ggf         , Gg          , Gg          , Gg          , Gg          , Gg          , Gg          , Gg          , Gg          , Gg          , Gg          , Gg          , Ww          , Ww          , Ww          , Ww          , Ww          , Ww          , Ww          , Ww          , Ww          , Ww          , Ww          , Ww          , Wwf         , Wwf         
Re          , Re          , Re          , Re          , Re          , Gg          , Gg          , Gg          , Gg          , Gg          , Gg          , Ww          , Ww          , Ww          , Ww          , Ww          , Ww          , Ww          , Wo          , Wo          , Wo          , Ww          , Wo          , Ww          , Ww          , Wwf         
