border_size=1
usage=map

Ms          , Ms          , Ms          , Ms          , Ms          , Ms          , Ms          , Ms          , Ms          , Ms          , Ms          , Ms          , Ha          , Ha          , Ha          , Ha          , Mm          , Mm          , Mm          , Mm          , Mm          , Mm          , Mm          , Mm          , Mm          , Gg          
Ms          , Ms          , Ha          , Ms          , Mm^Xm       , Ms          , Ms          , Ms          , Ms          , Ms          , Ms          , Ms          , Ha          , Ha          , Mm          , Mm          , Mm          , Mm          , Mm          , Mm          , Mm          , Mm          , Mm          , Mm          , Mm          , Mm          
Ms          , Ms          , Mm^Xm       , Mm^Xm       , Ms          , Mm^Xm       , Mm^Xm       , Ms          , Aa          , Ms          , Aa          , Aa          , Mm          , Mm          , Mm          , Mm          , Mm          , Mm          , Mm          , Mm^Xm       , Mm          , Mm          , Mm          , Mm          , Mm^Xm       , Mm          
Ms          , Mm^Xm       , Ms          , Ms          , Ai          , Ms          , Ms          , Mm^Xm       , Aa          , Aa          , Dd          , Aa          , Mm          , Mm          , Md^Xm       , Mm          , Rd          , Mm          , Mm          , Mm          , Mm          , Mm          , Mm          , Mm          , Mm          , Mm          
Mm^Xm       , Ms          , Ms          , Ms          , Aa          , Ai          , Ms          , Mm^Xm       , Ha          , Dd          , Dd          , Rd          , Rd          , Md^Xm       , Rd          , Rd          , Rd          , Rd          , Ds          , Mm          , Chr         , 3 Rp        , Chr         , Mm          , Mm          , Mm          
Ms          , Ms          , Ha          , Ha          , Aa          , Ai          , Wwf         , Mm^Xm       , Mm^Xm       , Dd          , Mm^Xm       , Dd          , Dd          , Rd          , Md^Xm       , Md^Xm       , Md^Xm       , Dd          , Rr          , Rr          , Ds          , Chr         , Ds          , Hd          , Hd          , Md^Xm       
Aa          , Ha          , Aa          , Aa          , Wo          , Wo          , Ha^Fma      , Mm          , Mm^Xm       , Mm^Xm       , Mm^Xm       , Md^Xm       , Dd          , Md^Xm       , Md^Xm       , Md^Xm       , Md^Xm       , Chr         , Dd          , Dd          , Dd          , Ds          , Ds          , Hd          , Hd          , Md^Xm       
Aa          , Aa          , Wo          , Wo          , Chr         , Chr         , Chr         , Chr         , Ms^Vhha     , Ha^Fma      , Md^Xm       , Md^Xm       , Md^Xm       , Md^Xm       , Md^Xm       , Md^Xm       , Dd          , Dd          , Dd          , Dd          , Dd          , Dd          , Ds          , Hd          , Hd          , Md^Xm       
Wo          , Wo          , Aa^Fda      , Ha^Fma      , Dd          , 2 Rp        , Dd          , Dd          , Dd          , Md^Xm       , Md^Xm       , Md^Xm       , Md^Xm       , Hd          , Hd          , Hd          , Hd          , Hd          , Dd^Do       , Dd^Vdt      , Dd          , Dd          , Ds          , Hd          , Hd          , Md^Xm       
Aa^Fda      , Ww          , Gs^Fp       , Aa^Fda      , Re          , Rp          , Dd          , Dd          , Dd          , Md^Xm       , Md^Xm       , Md^Xm       , Md^Xm       , Hd          , Dd          , Dd          , Dd          , Dd          , Dd          , Dd          , Dd          , Dd          , Ds          , Hd          , Dd^Do       , Md^Xm       
Ww          , Ww          , Gs^Fp       , Re^Vct      , Hh^Fmw      , Rd          , Dd          , Re^Vct      , Dd          , Dd          , Md^Xm       , Md^Xm       , Md^Xm       , Md^Xm       , Dd          , Dd          , Dd          , Dd          , Dd          , Ds          , Ds          , Ds          , Hd          , Dd^Vdt      , Ds          , Md^Xm       
Gs^Fp       , Gs^Fp       , Gs^Fp       , Re          , Hh          , Rd          , Dd          , Dd          , Dd          , Dd          , Md^Xm       , Md^Xm       , Md^Xm       , Md^Xm       , Dd          , Dd          , Dd          , Dd          , Ds          , Ds          , Hd          , Hd          , Ds          , Ds          , Ds          , Md^Xm       
Gs^Fp       , Gs^Fp       , Re          , Re          , Hh          , Rd          , Dd          , Dd          , Md          , Hd          , Md^Xm       , Md^Xm       , Md^Xm       , Dd          , Dd          , Dd          , Dd          , Dd          , Ds          , Hd          , Ds          , Md          , Md          , Ds          , Dd          , Md^Xm       
Gs^Fp       , Gs^Fp       , Re          , Hh          , Hh^Fmw      , Rd          , Hd          , Dd          , Hd          , Md          , Md          , Md^Xm       , Hd          , Hd          , Rd          , Dd          , Ds          , Ds          , Rd          , Rd          , Ds          , 1 Dd        , Dd          , Md          , Dd^Dc       , Ds          
Gs^Fp       , Gs^Fp       , Hh          , Hh          , Rd          , Rd          , Rd          , Md          , Md          , Md          , Hd          , Hd          , Md^Xm       , Dd          , Dd          , Rd          , Rd          , Rd          , Md          , Md          , Md          , Md          , Md          , Dd          , Dd          , Dd^Do       
Ww          , Hh          , Ggf         , Rd          , Mm^Xm       , Mm^Xm       , Mm^Xm       , Rd          , Rd          , Rd          , Dd^Do       , Dd          , Mm^Xm       , Dd          , Dd          , Hd          , Hd          , Md          , Md          , Md          , Md          , Dd          , Md          , Md          , Md          , Md          
Hh          , Ww          , Wwf         , Mm^Xm       , Mm^Xm       , Mm^Xm       , Mm^Xm       , Mm^Xm       , Mm^Xm       , Mm^Xm       , Mm^Xm       , Mm^Xm       , Mm^Xm       , Mm^Xm       , Mm^Xm       , Hd          , Mm^Xm       , Md          , Md          , Md          , Md          , Md          , Md          , Md          , Md          , Md^Xm       
Hh          , Hh          , Wwf         , Chw         , Hh          , Hh          , Hh          , Mm^Xm       , Mm^Xm       , Mm^Xm       , Hh          , Mm^Xm       , Hh          , Mm^Xm       , Mm^Xm       , Mm^Xm       , Mm^Xm       , Mm^Xm       , Mm^Xm       , Md^Xm       , Md^Xm       , Md          , Md^Xm       , Md          , Md^Xm       , Md^Xm       
