border_size=1
usage=map

Ms          , Ms          , Ms          , Ms          , Ms          , Ms          , Ms          , Ms          , Ms          , Ms          , Ms          , Ms          , Ms          , Ms          , Ms          , Ms          , Ms          , Ms          , Ms          , Xu          , Xu          , Xu          , Xu          , Xu          , Xu          , Xu          , Xu          , Qlf         , Qlf         , Xu          , Xu          , Xu          , Xu          , Xu          , Xu          , Ur          , Ur          , Xos         
Ms          , Ms          , Ms          , Ms          , Ms          , Ms          , Ms          , Ms          , Ms          , Ms          , Ms          , Ms          , Ms          , Ms          , Ms          , Ms          , Ms          , Ms          , Ms          , Xu          , Xu          , Xu          , Xu          , Xu          , Xu          , Xu          , Xu          , Xu          , Qlf         , Xu          , Xu          , Xu          , Xu          , Xu          , Xu          , Ur          , Xos         , Xos         
Ms          , Ms          , Ms          , Ms          , Ms          , Ms          , Ms          , Ms          , Ms          , Ms          , Ms          , Ms          , Ms          , Ms          , Ms          , Ms          , Ms          , Ms          , Ms          , Xu          , Hd          , Hd          , Hh^Fdf      , Xu          , Xu          , Xu          , Xu          , Xu          , Qlf         , Ql          , Ql          , Xu          , Ql          , Ql          , Ql          , Ur          , Xos         , Xos         
Ms          , Ms          , Ms          , Ms          , Ms          , Ms          , Ms          , Ms          , Aa          , Ms          , Ms          , Ms          , Ms          , Ms          , Ms          , Ms          , Ms          , Ms          , Ha          , Xu          , Hd          , Hd          , Hh^Fdw      , Dd          , Uu          , Ql          , Ql          , Ql          , Ql          , Uh          , Ql          , Ql          , Uh          , Ql          , Ur          , Ql^Bs|      , Ql          , Xos         
Ms          , Ms          , Ms          , Ha          , Ha          , Ha          , Ha          , Aa          , Aa          , Aa          , Ha          , Ha          , Ha          , Ha          , Ha          , Ha^Vhha     , Aa          , Ha          , Ds          , Xu          , Md          , Md          , Hh^Fdw      , Dd          , Dd          , Uu          , Uu          , Ql          , Uh          , Ql          , Uh          , Uh          , Ur          , Ur          , Ur          , Ur          , Xu          , Ql          
Ms          , Ms          , Ms          , Ha          , Ha          , Ha          , Ha          , Aa          , Ai          , Aa          , Aa          , Aa          , Aa          , Ha          , Aa          , Aa          , Ai          , Ds          , Ai          , Dd          , Dd          , Md          , Md          , Hh^Fdf      , Hh^Fdf      , Dd          , Dd          , Uu          , Uu          , Uh          , Uu^Vu       , Dd^Do       , Rd          , Ur          , Uh          , Uu^Vu       , Xu          , Xu          
Ms          , Ms          , Ms          , Ha          , Ha          , Ha          , Aa          , Aa          , Ai          , Ai          , Ai          , Ai          , Ai          , Aa          , Ai          , Ai          , Ai          , Ai          , Ai          , Ha          , Ha          , Dd          , Ha          , Md          , Md          , Hh^Fmf      , Md          , Hh^Fdw      , Md          , Hh^Fdf      , Ds          , Rd          , Rd          , Ur          , Cud         , Cud         , Xu          , Xu          
Ms          , Ms          , Ms          , Ha          , Ha          , Ha          , Aa          , Ai          , Ai          , Ai          , Ai          , Ai          , Ai          , Ai          , Ai          , Ai          , Ai          , Ai          , Ai          , Ha          , Ha          , Ds          , Ha          , Ha          , Ha          , Md          , Dd          , Md          , Dd          , Dd          , Ds          , Ds          , Xu          , Cud         , 3 Kud       , Xu          , Xu          , Xu          
Ms          , Ms          , Ha          , Aa          , Aa          , Aa          , Aa          , Ai          , Ai          , Ai          , Ai          , Ai          , Ai          , Ai          , Ai          , Ai          , Ai          , Ai          , Aa          , Ha          , Ha          , Ds          , Ha          , Ha          , Ha          , Ha          , Ha          , Dd          , Dd          , Ds          , Ds          , Md          , Md          , Xu          , Xu          , Xu          , Xu          , Xu          
Ms          , Ms          , Ha          , Ha          , Aa          , Aa          , Aa          , Aa          , Ai          , Ai          , Ai          , Ai          , Ai          , Ai          , Ai          , Ai          , Ai          , Ai          , Aa          , Aa          , Aa          , Ds          , Ha          , Ha          , Ha          , Ha          , Ha          , Ha          , Ha          , Hh^Fdw      , Hh^Fdw      , Ds          , Ds          , Md          , Md          , Md          , Xu          , Xu          
Ms          , Ms          , Ha          , Ha          , Aa          , Aa          , Aa          , Aa          , Ai          , Ai          , Ai          , Ai          , Ai          , Ai          , Ai          , Ai          , Ai          , Ai          , Aa          , Aa          , Dd          , Dd          , Ha          , Ha          , Ha          , Ha          , Ha          , Ha          , Ha          , Ha          , Ha          , Rd          , Ha          , Ds          , Ms          , Xu          , Xu          , Xu          
Ms          , Ms          , Ha          , Ha          , Aa          , Aa          , Aa          , Aa          , Aa          , Ai          , Ai          , Ai          , Aa          , Ai          , Aa          , Ai          , Aa          , Aa          , Aa          , Dd          , Aa          , Dd          , Ha          , Ha          , Ha          , Ha          , Ha          , Ha          , Ha          , Ha          , Rd          , Rd          , Ha          , Ha          , Ms          , Ms          , Ms          , Xu          
Ms          , Ms          , Ha          , Ha          , Ha          , Aa          , Aa          , Ha          , Ha          , Aa          , Aa          , Aa          , Aa          , Aa          , Aa          , Aa          , Aa          , Aa          , Aa          , Aa          , Ha          , Dd          , Dd          , Ha          , Ha          , Ha          , Ha          , Ha          , Rd          , Rd          , Ha          , Ha          , Ha          , Ha          , Ms          , Ms          , Ms          , Ms          
Ms          , Ms          , Ha          , Ha          , Ha          , Ha          , Ha          , Aa          , Ha          , Ha          , Ha          , Ha          , Ha          , Aa          , Ha          , Ha          , Ha          , Ha          , Ha          , Ha          , Ha          , Ha          , Ha          , Dd          , Ha          , Ha          , Rd          , Rd          , Ha          , Ha          , Ha          , Ha          , Ha          , Ha          , Ha          , Ms          , Ms          , Ms          
Ms          , Ms          , Ha          , Ha          , Ha          , Ha          , Ha          , Aa          , Aa          , Ha          , Ha          , Ha          , Ha          , Ha          , Ha          , Ha          , Ha          , Ha          , Ha          , Ha          , Ha          , Ha          , Ha          , Dd          , Rd          , Rd          , Ha          , Ha          , Ha          , Ha          , Ha          , Ha          , Ha          , Ha          , Ha          , Ha          , Ms          , Ms          
Ms          , Ms          , Ha          , Ha          , Ha          , Ha          , Ha          , Ha          , Aa          , Ha          , Ha          , Ha          , Ha          , Ha          , Ha          , Ha          , Ha          , Ha          , Ha          , Ha          , Ha          , Ha          , Ha          , Dd          , Dd          , Ha          , Ha          , Ha          , Ha          , Ha          , Ha          , Ha          , Ha          , Ha          , Ha          , Ms          , Ms          , Ms          
Ms          , Ha          , Ha          , Ha          , Ha          , Ha          , Ha          , Ha          , Ha          , Aa          , Aa          , Ha          , Ha          , Ha          , Ha          , Ha          , Ha          , Ha          , Ha          , Ha          , Ha          , Ha          , Ha          , Ha          , Ds          , Ha          , Ha          , Ha          , Ha          , Ha          , Ha          , Ha          , Ha          , Ha          , Ha          , Ms          , Ms          , Ms          
Ms          , Ms          , Ha          , Aa          , Ha          , Ha          , Ha          , Ha          , Ha          , Ha          , Ha          , Aa          , Ha          , Ha          , Ha          , Ha          , Ha          , Ha          , Ha          , Ha          , Ha          , Ha          , Ds          , Ds          , Ds          , Ds          , Ha          , Ha          , Ha          , Ha          , Ha          , Ha          , Ha          , Ha          , Ha          , Ms          , Ms          , Ms          
Ms          , Ms          , Ha          , Aa          , Ha          , Ha          , Ha          , Ha          , Ha          , Ha          , Ha          , Aa          , Aa          , Ha          , Ha          , Ha          , Ha          , Ha          , Ha          , Ha          , Dd          , Dd          , Ds          , Ds          , Ha          , Ha          , Ha          , Ha          , Ha          , Ha          , Ha          , Ha          , Ha          , Ha          , Ms          , Ms          , Ms          , Ms          
Ms          , Ha          , Ha          , Ha          , Ha          , Ha          , Ha          , Ha          , Ha          , Ha          , Ha          , Ha          , Aa          , Ha          , Ha          , Ha          , Ha          , Ha          , Dd          , Dd          , Ha          , Ha          , Ha          , Ha          , Ha          , Ha          , Ha          , Ha          , Ha          , Ha          , Ha          , Ha          , Ha          , Ha          , Ms          , Ms          , Ms          , Ms          
Ms          , Ms          , Ha          , Aa          , Ha          , Ha          , Ha          , Ha          , Ha          , Ha          , Ha          , Ha          , Aa          , Ha          , Ha          , Ha          , Rd          , Rd          , Ha          , Ha          , Ha          , Ha          , Ha          , Ha          , Ha          , Ha          , Ha          , Ha          , Ha          , Ha          , Ha          , Ha          , Ha          , Ha          , Ms          , Ms          , Ms          , Ms          
Ms          , Ms          , Ha          , Ha          , Ha          , Ha          , Ha          , Ha          , Ds          , Ds          , Ds          , Ha          , Rd          , Ha          , Rd          , Rd          , Ha          , Ha          , Ha          , Ha          , Ha          , Ha          , Ha          , Ha          , Ha          , Ha          , Ha          , Ha          , Ha          , Ha          , Ha          , Ha          , Ha          , Ha          , Ha          , Ms          , Ms          , Ms          
Ms          , Ha          , Ha          , Aa          , Ha          , Ha          , Ds          , Ds          , Ha          , Ha          , Ha          , Ds          , Rd          , Aa          , Ha          , Ha          , Ha          , Ha          , Ha          , Ha          , Ha          , Ha          , Ha          , Ha          , Md^Xm       , Md^Xm       , Md^Xm       , Ha          , Ha          , Ha          , Ha          , Ha          , Ha          , Ha          , Ha          , Ha          , Ms          , Ms          
Ms          , Ms          , Ha          , Aa          , Ds          , Ds          , Ha          , Ha          , Md^Xm       , Md^Xm       , Md^Xm       , Ha          , Rd          , Ha          , Ha          , Ha          , Ha          , Ha          , Ha          , Ha          , Md^Xm       , Ha          , Md^Xm       , Md^Xm       , Ha          , Ha          , Ha          , Md^Xm       , Md^Xm       , Ha          , Ha          , Ha          , Ha          , Ha          , Ha          , Ms          , Ms          , Ms          
Ms          , Ms          , Ha          , Ds          , Ha          , Ha          , Md^Xm       , Md^Xm       , Dd^Dr       , 4 Kh        , Ch          , Md^Xm       , Rd          , Ha          , Ha          , Ha          , Ha          , Ha          , Md^Xm       , Md^Xm       , Md^Xm       , Md^Xm       , Ha          , Ha          , Ha          , Ha          , Ha          , Ha          , Ha          , Md^Xm       , Md^Xm       , Ha          , Ha          , Ha          , Ms          , Ms          , Ms          , Ms          
Ms          , Ha          , Ha          , Ds          , Ha          , Ha          , Md^Xm       , Ch          , Ch          , Ch          , Rd          , Rd          , Hd          , Ha^Vhha     , Md^Xm       , Ha          , Md^Xm       , Md^Xm       , Md^Xm       , Md^Xm       , Ha          , Ha          , Aa          , Ha          , Ha          , Ai          , Aa          , Ha          , Ha          , Md^Xm       , Md^Xm       , Md^Xm       , Md^Xm       , Ha          , Md^Xm       , Ms          , Md^Xm       , Ms          
Ms          , Ms          , Ha          , Ds          , Ha          , Md^Xm       , Hd          , Dd^Dc       , Rd          , Rd          , Hd          , Hd          , Hd          , Hd          , Md^Xm       , Md^Xm       , Aa          , Aa          , Aa          , Ha          , Aa          , Aa          , Aa          , Aa          , Aa          , Aa          , Aa          , Aa          , Aa          , Aa          , Aa          , Md^Xm       , Ai          , Md^Xm       , Md^Xm       , Md^Xm       , Md^Xm       , Md^Xm       
Ms          , Ms          , Ds          , Ds          , Md^Xm       , Md^Xm       , Hd          , Hd          , Hd          , Hd          , Hd          , Hd          , Hd          , Hd          , Md^Xm       , Ha          , Aa          , Aa          , Aa          , Ha          , Aa          , Aa          , Aa          , Aa          , Aa          , Aa          , Aa          , Aa          , Aa          , Aa          , Aa          , Aa          , Ai          , Ai          , Ai          , Md^Xm       , Ms          , Md^Xm       
Ms          , Hd          , Ds          , Hd          , Md^Xm       , Ha^Fma      , Hd          , Ha          , Ha^Vhha     , Ha          , Ai          , Ha          , Ha          , Hd          , Md^Xm       , Md^Xm       , Ha          , Aa          , Aa          , Aa          , Aa          , Aa          , Aa          , Aa          , Aa          , Aa          , Aa          , Ha          , Ha          , Aa          , Aa          , Aa          , Ai          , Aa          , Ms          , Ms          , Ms          , Ms          
Ms          , Ms          , Ds          , Hd          , Hd          , Md^Xm       , Md^Xm       , Hd          , Ha          , Ai          , Ai          , Ai          , Ha          , Ha          , Hd          , Md^Xm       , Ha          , Ha          , Ds          , Ds          , Aa          , Aa          , Aa          , Aa          , Aa          , Aa          , Aa          , Aa          , Aa          , Aa          , Ai          , Ai          , Aa          , Aa          , Ms          , Ms          , Ms          , Ms          
Ms          , Ms          , Ha          , Ds          , Hd          , Hd          , Md^Xm       , Hd          , Hd          , Ha          , Hd          , Ha          , Ha          , Hd          , Md^Xm       , 2 Md^Xm     , Ds          , Ds          , Aa          , Aa          , Aa^Vca      , Aa          , Aa          , Aa          , Ha          , Aa          , Aa          , Aa          , Aa          , Aa          , Ai          , Aa          , Ha          , Ha          , Ms          , Ms          , Ms          , Ms          
Ms          , Ms          , Ha          , Ds          , Aa          , Hd          , Hd          , Md^Xm       , Md^Xm       , Md^Xm       , Md^Xm       , Hd          , Md^Xm       , Md^Xm       , Dd          , Dd          , Aa          , Aa          , Aa          , Aa          , Aa          , Aa          , Aa          , Aa          , Ha          , Ha          , Ha          , Aa          , Aa          , Ai          , Aa          , Aa          , Ha          , Ha          , Ms          , Ms          , Ms          , Ms          
Ms          , Ms          , Ms          , Ha          , Ds          , Hd          , Aa          , Hd          , Ds          , Ha          , Ha          , Md^Xm       , Dd          , Dd          , Dd          , Aa          , Aa          , Aa          , Aa          , Aa          , Aa          , Aa          , Ha          , Ha          , Ha          , Ha          , Ha          , Aa          , Aa          , Ai          , Aa          , Aa          , Ha^Vca      , Ha          , Ms          , Ms          , Ms          , Ms          
Ms          , Ms          , Ms          , Ha          , 1 Ds        , Aa          , Ha          , Ds          , Ha          , Ds          , Ds          , Aa          , Ha          , Ha          , Ha          , Dd          , Hd          , Hd          , Hd          , Aa          , Ha          , Ha          , Ms          , Ms          , Ms          , Ha          , Ha          , Aa          , Aa          , Ai          , Aa          , Aa          , Ms          , Ha          , Ms          , Ms          , Ms          , Ms          
Ms          , Ms          , Aa          , Aa          , Ms          , Ms          , Ms          , Ha          , Ms          , Ms          , Ms          , Ha          , Ms          , Ms          , Ms          , Ms          , Ms          , Ms          , Ms          , Ms          , Ms          , Ms          , Ms          , Ms          , Ms          , Ms          , Ms          , Ms          , Ai          , Ai          , Ms          , Ms          , Ms          , Ms          , Ms          , Ms          , Ms          , Ms          
Aa          , Aa          , Ms          , Ms          , Ms          , Ms          , Ms          , Ms          , Ms          , Ms          , Ms          , Ms          , Ms          , Ms          , Ms          , Ms          , Ms          , Ms          , Ms          , Ms          , Ms          , Ms          , Ms          , Ms          , Ms          , Ms          , Ai          , Ai          , Ms          , Ms          , Ms          , Ms          , Ms          , Ms          , Ms          , Ms          , Ms          , Ms          
