border_size=1
usage=map

Ms          , Ms          , Ms          , Ms          , Ms          , Xos         , Xos         , Xos         , Xos         , Rr          , Rr          , Rr          , Xos         , Xos         , Xos         , Xos         , Xos         , Ms          , Ms          , Ms          , Ms          , Ms          , Ms          , Ms          , Wo          , Ww          , Ms          , Ms          
Ms          , Ms          , Ms          , Ms          , Ms          , Xos         , Xos         , Xos         , Xos         , Rr          , Rr          , Rr          , Xos         , Xos         , Xos         , Xos         , Xos         , Ms          , Ms          , Ms          , Ms          , Ms          , Ms          , Ms          , Wo          , Ww          , Ms          , Ms          
Ms          , Ms          , Ms          , 1 Kh        , Ch          , Xos         , Xos         , Xos         , Xos         , Rr          , Rr          , Rr          , Xos         , Xos         , Xos         , Xos         , Cud         , 2 Kud       , Hh^Fdw      , Ms          , Hh^Fdw      , Ms          , Hh^Fds      , Wo          , Ww          , Ww^Vm       , Ms          , Ms          
Ms          , Ms          , Ms          , Ch          , Ch          , Ch          , Gg          , Xos         , Xos         , Rp          , Rp          , Rp          , Xos         , Xos         , Cud         , Cud         , Ss          , Ss          , Ss          , Hh^Fds      , Ss          , Hh^Fds      , Wo          , Wo          , Ww          , Ms          , Ms          , Ms          
Ms          , Ms          , Ms          , Ch          , Rp          , Gg          , Gg          , Gg          , Gg^Fet      , Rp          , Rp          , Rp          , Ggf         , Cud         , Wwf         , Ss          , Gs^Fp       , Gs^Fp       , Ss          , Gs^Fp       , Ss          , Ss^Vm       , Wo          , Wo          , Hh^Fp       , Ms          , Ms          , Ms          
Ms          , Ms          , Ms          , Hh          , Gg          , Rp          , Rp          , Rp^Vhc      , Rp^Vhc      , Rp          , Rp          , Rp          , Gg^Fet      , Ggf         , Wwf         , Ss          , Gs^Fp       , Gs^Fmf      , Ss          , Ss          , Wo          , Wo          , Gg^Wm       , Ggf         , Re^Gvs      , Hh^Fp       , Ms          , Ms          
Ms          , Ms          , Ms          , Hh          , Gg          , Ggf         , Gg          , Gg          , Gg^Fet      , Rp          , Rp          , Rp          , Rp^Vhc      , Rp^Vhc      , Ww          , Gs^Fp       , Ww          , Chw         , Chw         , Wo          , 5 Khw       , Ggf         , Re^Gvs      , Re^Gvs      , Hh^Vhh      , Hh^Fp       , Ms          , Ms          
Ms          , Ms          , Ms          , Hh^Fp       , Hh^Fp       , Gg          , Gg          , Rp^Vhc      , Rp^Vhc      , Rp          , Rp          , Rp          , Gg^Fet      , Ggf         , Ww          , Ww          , Ww          , Ww          , Wo          , Chw         , Re^Gvs      , Re^Gvs      , Re          , Re          , Re^Gvs      , Hh^Fp       , Ms          , Ms          
Ms          , Ms          , Ms          , Aa^Fda      , Hh^Fp       , Gg          , Gg          , Gg          , Gg^Fet      , Rp          , Rp          , Rp          , Rp^Vhc      , Rp^Vhc      , Ww          , Ww          , Wo          , Wo          , Re^Gvs      , Re^Gvs      , Re          , Re          , Re^Gvs      , Re^Gvs      , Re^Gvs      , Rp          , Ha^Fma      , Ms          
Ms          , Ms          , Aa^Fda      , Hh^Fp       , Ggf         , Gg          , Gg          , Rp^Vhc      , Rp^Vhc      , Rp          , Rp          , Rp          , Gg^Fet      , Ggf         , Wo          , Wo          , Re^Gvs      , Re^Gvs      , Re^Gvs      , Re^Gvs      , Re^Gvs      , Re^Gvs      , Re^Gvs      , Re^Gvs      , Re^Gvs      , Rp          , Ms          , Ms          
Ms          , Aa^Fda      , Aa^Fda      , Hh^Fp       , Gg          , Gg          , Gg          , Ggf         , Gg^Fet      , Rp          , Ur          , Ur          , Wo          , Wo          , Wwf         , Wwf         , Re^Gvs      , Re^Gvs      , Re^Gvs      , Re^Gvs      , Re^Gvs      , Re^Gvs      , Re^Gvs      , Re^Gvs      , Gg^Wm       , Rp          , Mm^Xm       , Mm^Xm       
Wo          , Aa^Fda      , Hh^Fp       , Hh^Fp       , Gg          , Gg          , Gg          , Ggf         , Re          , Ur          , Ww^Bw|      , Ww^Bw|      , Ss          , Re          , Re^Gvs      , Re^Gvs      , Re^Gvs      , Re^Gvs      , Re^Gvs      , Re^Gvs      , Re^Gvs      , Re^Gvs      , Gg^Vh       , Ggf         , Rp          , Rp          , Mm^Xm       , Mm^Xm       
Ms          , Wo          , Wo          , Wo          , Wo          , Gg          , Ss          , Re          , Wo          , Ww^Bw|      , Ur          , Ur          , Rp          , Rp          , Rp          , Re^Gvs      , Re^Gvs      , Re^Gvs      , Re^Gvs      , Re^Gvs      , Rp          , Rp          , Rp          , Rp          , Gs^Fms      , Gs^Fp       , Mm^Xm       , Mm^Xm       
Ms          , Ms          , Re          , Re          , Ss^Vm       , Wo          , Wo          , Wo          , Re          , Ur          , Rp          , Rp          , Gs^Ft       , Gs^Ft       , Gs^Ft       , Rp          , Rp          , Re^Gvs      , Rp          , Rp          , Ggf         , Ggf         , Gs^Ft       , Gs^Ft       , Gs^Ft       , Gs^Fp       , Mm^Xm       , Mm^Xm       
Ms          , Ms          , Re          , Re          , Re          , Ss          , Ww          , Re          , Re          , Rp          , Rp          , Rp          , Gs^Ft       , Gs^Ft       , Gs^Ft       , Gs^Ft       , Xos         , Rp          , Xos         , Ggf         , Gs^Ft       , Gs^Ft       , Gs^Ft       , Gs^Ft       , Gs^Fms      , Gs^Fp       , Mm^Xm       , Ms          
Ms          , Ms          , Ww          , Re          , Ww          , Ww          , Re          , Re          , Re          , Rp          , Rp          , Rp          , Gs^Ft       , Gs^Ft       , Xos         , Xos         , Ur          , Xos         , Xos         , Xos         , Xos         , Ur          , Ur          , Gs^Ft       , Gs^Ft       , Gs^Fp       , Gs^Fp       , Ms          
Ms          , Ms          , Ms          , Ww          , Ww          , Re          , Re          , Re          , Re^Gvs      , Rp          , Rp          , Rp          , Rp          , Rp          , Xos         , Xos         , Xos         , Xos         , Uh          , Uu          , Qlf         , Ur          , Uu          , Ur          , Gs^Fms      , Gs^Fp       , Mm^Xm       , Ms          
Ms          , Ms          , Ms          , Ww          , Re^Gvs      , Re^Gvs      , Re^Gvs      , Re^Gvs      , Re^Gvs      , Rp          , Rp          , Rp          , Rp          , Xos         , Xos         , Xos         , Uu          , Uu          , Qlf         , Qlf         , Ql          , Ql          , Uh          , Ur          , Gs^Ft       , Gs^Fp       , Mm^Xm       , Ms          
Ms          , Ms          , Ms          , Ww          , Ww          , Re^Gvs      , Re^Gvs      , Re^Gvs      , Re^Gvs      , Rp          , Rp          , Rp          , Gg^Fet      , Ggf         , Ggf         , Xos         , Ur          , Qlf         , Ql          , Ql          , Ql          , Ql          , Uh          , Gs^Ft       , Gs^Ft       , Gs^Fp       , Mm^Xm       , Mm^Xm       
Ms          , Ms          , Ms          , Gs^Fdf      , Ww          , Re^Gvs      , Ww          , Re^Gvs      , Re^Gvs      , Rp          , Rp          , Rp          , Ggf         , Gs^Ft       , Gs^Ft       , Ggf         , Ur          , Uu          , Ql          , Ql          , Uh          , Uh          , Uu^Vud      , Gs^Fms      , Gs^Fms      , Gs^Fp       , Mm^Xm       , Hh^Fms      
Ms          , Ms          , Ms          , Gs^Fmf      , Re^Gvs      , Re^Gvs      , Re^Gvs      , Re^Gvs      , Re^Gvs      , Rp          , Rp          , Rp          , Gg^Fet      , Ggf         , Gs^Ft       , Gs^Ft       , Gs^Ft       , Uu          , Uu          , Ql          , Ql          , Uu          , Uu          , Ur          , Ur          , Gs^Fp       , Mm^Xm       , Hh^Fms      
Ms          , Ms          , Hh^Vhh      , Gs^Fmf      , Re^Gvs      , Re^Gvs      , Re^Gvs      , Re^Gvs      , Re^Gvs      , Rp          , Rp          , Rp          , Gg          , Ggf         , Gs^Ft       , Gs^Fms      , Gs^Ft       , Gs^Fms      , Gs^Fms      , Uu          , Uu          , Ql          , Ql^Bs/      , Uu          , Uu          , Uu          , Mm^Xm       , Mm^Xm       
Ms          , Ms          , Ms          , Gs^Fmf      , Gs^Fmf      , Re          , Re^Gvs      , Re^Gvs      , Re^Gvs      , Rp          , Rp          , Rp          , Gg          , Gs^Fms      , Gs^Fms      , Gs^Fms      , Gs^Fms      , Gs^Fms      , Gs^Ft       , Gs^Fms      , Ur          , Uu          , Uu          , Ql          , Ql          , Ur          , Mm^Xm       , Mm^Xm       
Ms          , Ms          , Ms          , Gs^Fmf      , Re^Gvs      , Re^Gvs      , Re^Gvs      , Re^Gvs      , Re^Gvs      , Rp          , Rp          , Rp          , Gs^Fms      , Gs^Fms      , Gg          , Gg          , Gg          , Gs^Ft       , Gs^Ft       , Ss          , Ss          , Uu          , Uu^Vud      , Uu          , Ql          , Ur          , Mm^Xm       , Ql          
Ms          , Ms          , Ms          , Gs^Fmf      , Re^Gvs      , Re^Gvs      , Re^Gvs      , Re          , Re^Gvs      , Rp          , Rp          , Rp          , Gg          , Gg          , Gg          , Gg^Vh       , Gg          , Gs^Ft       , Gs^Ft       , Ss          , Ss          , Ur          , Uu          , Uu          , Ql          , Ql          , Ql          , Ql          
Ms          , Ms          , Ms          , Gs^Fmf      , Re^Gvs      , Re^Gvs      , Re^Gvs      , Re^Gvs      , Re^Gvs      , Rp          , Rp          , Rp          , Gg          , Gg          , Gg          , Gg          , Gg          , Gs^Ft       , Gs^Ft       , Ss          , Ww          , Ur          , Uu          , Uu          , Ql          , Ql          , Mm^Xm       , Ql          
Ms          , Ms          , Ms          , Gs^Fdf      , Hh^Fdf      , Re^Gvs      , Re^Gvs      , Re^Gvs      , Re^Gvs      , Rp          , Rp          , Rp          , Gg          , Gg          , Gg          , Gg          , Gg^Vh       , Gg          , Gg          , Gs^Ft       , Ss          , Ur          , Uu          , Ql          , Uu          , Ur          , Mm^Xm       , Mm^Xm       
Ms          , Ms          , Ms          , Hh^Fdf      , Aa^Fma      , Hh^Fdf      , Re          , Re          , Re          , Rp          , Rp          , Rp          , Gg          , Gg          , Gg          , Gg          , Gg          , Gg          , Gs^Ft       , Gs^Ft       , Gg          , Ur          , Uu          , Ql          , Uu          , Ur          , Mm^Xm       , Mm^Xm       
Ms          , Ms          , Aa^Fma      , Aa^Fma      , Hh^Fdf      , Hh^Fdf      , Re          , Re          , Gg^Vh       , Rp          , Rp          , Rp          , Gg          , Gg^Vh       , Gg          , Gg          , Gg          , Gg          , Gs^Ft       , Gs^Fms      , Gg          , Gs^Fms      , Uu          , Ql          , Uu          , Ur          , Mm^Xm       , Md          
Ms          , Ms          , Aa^Fma      , Hh^Fdf      , Gs^Fmf      , Re^Gvs      , Re^Gvs      , Re          , Re^Gvs      , Rp          , Rp          , Rp          , Gg          , Gg          , Gg          , Gg          , Gg          , Gg          , Gg          , Gs^Ft       , Gg          , Gg          , Uu          , Ql          , Uu          , Ur          , Hd          , Md          
Ms          , Ms          , Aa^Fma      , Gs^Fdf      , Gs^Fmf      , Re^Gvs      , Re          , Re^Gvs      , Re^Gvs      , Rp          , Rp          , Rp          , Gg          , Gg          , Gg          , Gg          , Gg          , Gs^Ft       , Gs^Ft       , Gg          , Gs^Ft       , Gg          , Uu          , Ql          , Uu          , Ur          , Md^Xm       , Ms          
Ms          , Ms          , Ms          , Gs^Fmf      , Gs^Fmf      , Re^Gvs      , Re^Gvs      , Re^Gvs      , Re^Gvs      , Rp          , Rp          , Rp          , Gg          , Gg          , Gg          , Gg          , Gg^Vh       , Gg          , Gs^Ft       , Gs^Ft       , Gg          , Gg          , Uu          , Ql          , Uu          , Ur          , Md^Xm       , Md^Xm       
Ms          , Ms          , Ms          , Aa^Fma      , Gs^Fmf      , Gs^Fmf      , Re^Gvs      , Re^Gvs      , Re^Gvs      , Rp          , Rp          , Rp          , Gg          , Gg          , Gg          , Gg          , Gg          , Gg          , Gs^Ft       , Gs^Ft       , Gg          , Gg          , Uu          , Ql          , Uu          , Ur          , Md^Xm       , Md^Xm       
Ms          , Ms          , Ms          , Aa^Fma      , Gs^Fmf      , Re          , Re          , Re^Gvs      , Re^Gvs      , Rp          , Rp          , Rp          , Gg          , Gg          , Gg          , Gg          , Gg          , Gg          , Gs^Ft       , Gs^Ft       , Gg          , Gg          , Uu          , Ql          , Uu          , Uu          , Md^Xm       , Ms          
Ms          , Ms          , Aa^Fda      , Aa^Fma      , Gs^Fmf      , Gg          , Gg          , Gg^Wm       , Gg          , Rp          , Rp          , Rp          , Gg          , Gg          , Gg          , Gg          , Gg          , Gg          , Gg          , Gg          , Gs^Ft       , Gg          , Uu          , Ql          , Ql          , Uu          , Md^Xm       , Md^Xm       
Ms          , Ms          , Aa^Fda      , Gs^Fmf      , Re          , Re          , Re          , Gg          , Ggf         , Rp          , Rp          , Rp          , Gg          , Gg          , Gg          , Gg^Vh       , Gg          , Ww          , Gg          , Gs^Ft       , Gs^Ft       , Gg          , Ur          , Uu          , Ql          , Uu          , Md^Xm       , Md^Xm       
Ms          , Ms          , Aa^Fda      , Gs^Fmf      , Re          , Re          , Re          , Gg          , Re          , Rp          , Rp          , Rp          , Gg          , Gg          , Gg          , Gg          , Gg          , Gs^Ft       , Gs^Ft       , Gg          , Dd^Vda      , Dd          , Ur          , Uu          , Ql          , Uu          , Md^Xm       , Md^Xm       
Ms          , Ms          , Aa^Fda      , Gs^Fmf      , Gs^Fmf      , Re          , Re          , Re          , Re          , Rp          , Rp          , Rp          , Gg          , Gg          , Gg          , Gg          , Gg          , Gs^Ft       , Gs^Ft       , Gs^Ft       , Gs^Ft       , Dd          , Ur          , Uu          , Ql          , Uu          , Md^Xm       , Md^Xm       
Ms          , Ms          , Ms          , Aa^Fda      , Ce          , Ce          , Ce          , Re          , Re          , Rp          , Rp          , Rp          , Gg          , Gg          , Gg          , Gg          , Gg          , Gg^Vh       , Gs^Ft       , Dd          , Gs^Ft       , Gs^Ft       , Ur          , Ur          , Ql          , Uu          , Md^Xm       , Md^Xm       
Xu          , Ms          , Ms          , Aa^Fda      , Ce          , 3 Ke        , Ce          , Re          , Re          , Rp          , Rp          , Rp          , Cud         , Gg          , Gg          , Gg          , Gg          , Gg          , Dd          , Dd          , Gs^Ft       , Dd          , Ur          , Uu          , Ql          , Uu          , Md^Xm       , Md^Xm       
Xu          , Xu          , Ai          , Ww          , Ww          , Ce          , Xu          , Re          , Xu          , Rp          , Rp          , Rp          , 4 Kud       , Cud         , Cud         , Gg          , Hd          , Dd          , Dd          , Gs^Ft       , Dd          , Dd          , Ur          , Uu          , Ql          , Ql          , Xu          , Xu          
Xu          , Xu          , Xu          , Xu          , Xu          , Xu          , Xu          , Xu          , Xu          , Rr          , Rr          , Rr          , Xu          , Xu          , Xu          , Xu          , Xu          , Hd          , Xu          , Hd          , Xu          , Hd          , Ur          , Uu          , Ur          , Ql          , Uh          , Xu          
Xu          , Xu          , Xu          , Xu          , Xu          , Xu          , Xu          , Xu          , Xu          , Rr          , Rr          , Rr          , Xu          , Xu          , Xu          , Xu          , Xu          , Xu          , Xu          , Xu          , Xu          , Xu          , Xu          , Ur          , Uh          , Ql          , Ql          , Uh          
Xu          , Xu          , Xu          , Xu          , Xu          , Xu          , Xu          , Xu          , Xu          , Rr          , Rr          , Rr          , Xu          , Xu          , Xu          , Xu          , Xu          , Xu          , Xu          , Xu          , Xu          , Xu          , Xu          , Xu          , Xu          , Uh          , Uh          , Ql          
