border_size=1
usage=map

Xu          , Xu          , Xu          , Xu          , Xu          , Xu          , Xu          , Xu          , Xu          , Xu          , Xu          , Xu          , Xu          , Xu          , Xu          , Xu          , Wo          , Wo          , Wo          , Wo          
Xu          , Xu          , Xu          , Xu          , Xu          , Xu          , Xu          , Xu          , Xu          , Xu          , Xu          , Xu          , Xu          , Xu          , Xu          , Xu          , Xu          , Xu          , Xu          , Xu          
Xu          , Xu          , Xu          , Xu          , Xu          , Xu          , Xu          , Xu          , Xu          , Xu          , Xu          , Xu          , Xu          , Xu          , Xu          , Xu          , Xu          , Xu          , Xu          , Xu          
Xu          , Xu          , Xu          , Xu          , Xu          , Xu          , Xu          , Xu          , Wo          , Xu          , Xu          , Xu          , Xu          , Xu          , Xu          , Xu          , Xu          , Xu          , Xu          , Xu          
Wo          , Xu          , Xu          , Xu          , Xu          , Xu          , Xu          , Wo          , Wo          , Wo          , Wo          , Ww          , Wwf         , Ww          , Ww          , Ww          , Ww          , Wo          , Wo          , Wo          
Wo          , Wo          , Wo          , Wo          , Wo          , Xu          , Wo          , Wo          , Wo          , Wo          , Wwf         , Wwf         , Rd          , Wwf         , Wwf         , Ww          , Ww          , Ww          , Ww          , Ww          
Wo          , Wo          , Wo          , Wo          , Wo          , Wo          , Wo          , Wo          , Wwf         , Wwf         , Rd          , Rd          , Hd          , Rd          , Rd          , Wwf         , Wwf         , Ww          , Ww          , Ww          
Wwf         , Wo          , Wwf         , Wo          , Wwf         , Wo          , Wwf         , Wwf         , Rd          , Rd          , Hd          , Hd          , Chw         , Hd          , Hd          , Rd          , Rd          , Wwf         , Wwf         , Ww          
Wwf         , Wwf         , Wwf         , Wwf         , Wwf         , Wwf         , Rd          , Rd          , Hd          , Hd          , Chw         , Chw         , Dd^Do       , Chw         , Chw         , Hd          , Hd          , Rd          , Rd          , Wwf         
Ww          , Wwf         , Ww          , Wwf         , Ww          , Wwf         , Wwf         , Rd          , Rd          , Hd          , Hd          , Chw         , Chw         , Chw         , Hd          , Hd          , Rd          , Rd          , Wwf         , Wwf         
Wo          , Wo          , Wo          , Wo          , Wo          , Wo          , Wo          , Wwf         , Wwf         , Rd          , Rd          , Hd          , Hd          , Hd          , Rd          , Rd          , Wwf         , Wwf         , Uu          , Uu          
Wo          , Wo          , Wo          , Wo          , Ds          , Wo          , Wo          , Wo          , Wo          , Wwf         , Wwf         , Rd          , Rd          , Rd          , Wwf         , Wwf         , Wo          , Wo          , Wo          , Uu          
Wo          , Wo          , Uu^Uf       , Ds          , Ds          , Wo          , Wo          , Wo          , Wo          , Wo          , Wo          , Wwf         , Wwf         , Wwf         , Wo          , Ww          , Wo          , Wo          , Wo          , Wo          
Wo          , Wo          , Uu^Uf       , Uu^Uf       , Ww          , 2 Ds        , Wo          , Wo          , Wo          , Wo          , Wo          , Wwf         , Wwf         , Wwf         , Wo          , Wo          , Wo          , Wo          , Wo          , Wo          
Wo          , Wo          , Wo          , Ww          , Ww^Vm       , Ww          , Wo          , Wo          , Wo          , Ww          , Ww          , Wwf         , Wwf         , Wwf         , Wo          , Wo          , Wo          , Ww          , Wo          , Wo          
Wo          , Wo          , Wo          , Wo          , Wo          , Wo          , Wo          , Wo          , Wo          , Ww          , Ww          , Wwf         , 1 Wwf       , Wwf         , Wo          , Wo          , Wo          , Wo          , Wo          , Wo          
Xu          , Xu          , Xu          , Wo          , Wo          , Wo          , Wo          , Wo          , Wo          , Ww          , Wo          , Wwf         , Wwf         , Wwf         , Wo          , Wo          , Wo          , Wo          , Wo          , Wo          
Xu          , Xu          , Xu          , Xu          , Xu          , Wo          , Wo          , Wo          , Wo          , Wo          , Xu          , Ww          , Xu          , Wwf         , Xu          , Wo          , Xu          , Wo          , Xu          , Wo          
Xu          , Xu          , Xu          , Xu          , Xu          , Xu          , Xu          , Xu          , Xu          , Xu          , Xu          , Xu          , Xu          , Xu          , Xu          , Xu          , Xu          , Xu          , Xu          , Xu          
Xu          , Xu          , Xu          , Xu          , Xu          , Xu          , Xu          , Xu          , Xu          , Xu          , Xu          , Xu          , Xu          , Xu          , Xu          , Xu          , Xu          , Xu          , Xu          , Xu          
