border_size=1
usage=map

Xos         , Xos         , Xos         , Xos         , Xos         , Xos         , Ur          , Xos         , Xos         , Xos         , Xos         , Ur          , Ur          , Ur          
Xos         , Xos         , Xos         , Xos         , Xos         , Xos         , Ur          , Xos         , Xos         , Xos         , Xos         , Xos         , Xos         , Ur          
Xos         , Xos         , Xos         , Xos         , Ai          , Ai          , Ai          , Ai          , Ai          , Xos         , Xos         , Xos         , Xos         , Xos         
Xos         , Xos         , Ai          , Ai          , Ai          , Ai          , Ai          , Ai          , Ai          , Ai          , Ai          , Xos         , Xos         , Xos         
Xos         , Xos         , Ai          , Ai          , Ai          , Ai          , Ai          , Ai          , Ai          , Ai          , Ai          , Xos         , Xos         , Xos         
Xos         , Xos         , Ai          , Ai          , Ai          , Ai          , Ai          , Ai          , Ai          , Ai          , Ai          , Ai          , Xos         , Xos         
Xos         , Xos         , Xos         , Ai          , Ai          , Ai          , Ai          , Ai          , Ai          , Ai          , Ai          , Ai          , Ai          , Xos         
Ggf         , Xos         , Xos         , Xos         , Xos         , Ai          , Ai          , Ai          , Ai          , 1 Ai        , Ai          , Ai          , Ql          , Xos         
Ggf         , Ggf         , Ggf         , Xos         , Xos         , Xos         , Ai          , Ai          , Ai          , Ai          , 2 Ai        , Ai          , Ai          , Xos         
Ggf         , Ggf         , Xos         , Ggf         , Xos         , Xos         , Rp          , Ai          , Xos         , Ai          , Ai          , Ai          , Xos         , Xos         
Xos         , Xos         , Xos         , Ggf         , Xos         , Xos         , Rp          , Xos         , Xos         , Xos         , Xos         , Xos         , Ggf         , Ggf         
Xos         , Xos         , Xos         , Ggf         , Xos         , Xos         , Ggf         , Xos         , Xos         , Xos         , Ggf         , Ggf         , Ggf         , Ggf         
