border_size=1
usage=map

Gs^Fp       , Gs^Fp       , Gs^Fp       , Gg          , Gg          , Gg          , Gg          , Ww          , Ss          , Ww          , Ggf         , Ggf         , Re^Gvs      , Re^Gvs      , Re^Gvs      , Re^Gvs      , Re^Gvs      , Gs^Fp       
Gs^Fp       , Gs^Fp       , Gs^Fp       , Gg^Vh       , Gg          , Gg          , Ww          , Ww          , Ch          , Ww          , Ww          , Re^Gvs      , Re^Gvs      , Re^Gvs      , Re^Gvs      , Re^Gvs      , Re^Gvs      , Gs^Fp       
Gs^Fp       , Gs^Fp       , Gg          , Gg          , Gg          , Gg          , Ww          , 1 Kh        , Xv          , Ch          , Ch          , Ww          , Re^Gvs      , Re^Gvs      , Re^Gvs      , Re^Gvs      , Re^Gvs      , Gs^Fp       
Gg          , Gg          , Gg          , Gg          , Gg          , Gg          , Ww          , Ch          , Ch          , Xv          , Ch          , Ww          , Re^Gvs      , Re^Gvs      , Re^Gvs      , Re^Gvs      , Gg^Vh       , Gg          
Gg          , Gg          , Gg          , Gg          , Gg          , Gg^Vh       , Gg          , Ww          , Ww          , Ch          , Ww          , Ww^Bw\      , Rr          , Re^Gvs      , Re^Gvs      , Re^Gvs      , Gg          , Gg          
Rd          , Gg          , Hh^Fds      , Gg          , Hh^Fms      , Gg          , Gg          , Gg          , Gg          , Ww          , Ggf         , Ggf         , Rr          , 2 Ch        , Kh          , Gg          , Gg          , Gg          
Hh^Fds      , Rd          , Mm          , Hh^Fds      , Hh^Fp       , Hh^Fms      , Hh^Fds      , Gg          , Ggf         , Ggf         , Ggf         , Ggf         , Rr          , Rd          , Rd          , Ch          , Gg          , Gg          
Hh^Fds      , Mm          , Mm          , Hh^Fds      , Hh^Vc       , Hh^Fp       , Hh^Fds      , Ggf         , Ggf         , Ggf         , Ggf         , Ggf         , Rr          , Ggf         , Gg          , Rd          , Rd          , Re^Gvs      
Hh^Fds      , Hh^Fds      , Hh^Fds      , Hh^Fds      , Rd          , Hh^Fms      , Hh^Fms      , Hh^Fp       , Hh^Fds      , Ggf         , Ggf         , Ggf         , Rr          , Gg          , Gg          , Gg          , Gg^Vh       , Rd          
Hh^Fds      , Hh^Fds      , Rd          , Rd          , Hh^Fds      , Hh^Fds      , Hh^Fds      , Hh^Fms      , Hh^Fms      , Rd          , Rd          , Rd          , Rr          , Gg          , Gg          , Gg          , Gg          , Gg          
Rd          , Rd          , Hh^Fp       , Hh^Fp       , Hh^Fds      , Hh^Fds      , Hh^Fds      , Hh^Fds      , Gg          , Gg          , Gg          , Gg          , Rr          , Gg          , Gg          , Gg          , Gg          , Gg          
Gs^Fp       , Gs^Fp       , Gs^Fp       , Hh^Fms      , Hh^Fms      , Hh^Fds      , Hh^Fds      , Hh^Fds      , Hh^Fds      , Gg          , Gg          , Gg          , Rd          , Gg          , Gg          , Gg          , Gg          , Gg          
Gs^Fp       , Gs^Fp       , Gs^Fp       , Gs^Fp       , Ggf         , Hh^Fds      , Hh^Fds      , Hh^Fds      , Hh^Fds      , Hh^Fms      , Hh^Fmf      , Hh^Fms      , Hh^Fmf      , Rd          , Hh^Fms      , Gg          , Gg          , Gs^Fp       
Gs^Fp       , Gs^Fp       , Gs^Fp       , Gs^Fp       , Gg          , Gg          , Gg          , Hh^Fds      , Hh^Fds      , Hh^Fds      , Hh^Fds      , Hh^Fms      , Hh^Fms      , Hh^Fmf      , Hh^Fms      , Hh          , Hh^Fms      , Gs^Fp       
Hh^Fds      , Gg^Vc       , Gg          , Rd          , Gg          , Gg          , Gg          , Gg          , Gg          , Hh^Fds      , Gg          , Gg          , Rd          , Hh^Fms      , Gg          , Hh^Fms      , Hh          , Hh^Fms      
Hh^Fds      , Gg          , Gg          , Rd          , Gg          , Gg          , Gg          , Gg          , Gg          , Gg          , Gg          , Gg          , Rd          , Gg^Vc       , Gg          , Gg          , Hh          , Hh^Fms      
Hh^Fds      , Gg          , Ce          , Rd          , Gg          , Gg          , Gg          , Gg          , Gg          , Gg          , Gg          , Gg          , Rd          , Gg          , Gg          , Gg          , Hh          , Hh^Fms      
Hh^Fds      , Gg          , Gg          , Ce          , Ce          , Gg^Vc       , Ce          , Gg          , Gg          , Gg          , Gg          , Gg          , Rr          , Gg          , Gg          , Gg          , Hh          , Hh^Fmf      
Hh^Fds      , Gg          , Hh^Fds      , 3 Ke        , Hh^Fds      , Ce          , Hh^Fds      , Gg          , Gg          , Gg          , Gg          , Gg          , Rd          , Gg          , Gg          , Gg          , Hh          , Hh^Fmw      
Mm          , Hh^Fds      , Hh^Fmw      , Hh^Fds      , Hh^Fmw      , Hh^Fds      , Hh^Fmw      , Hh^Fds      , Gg          , Gg          , Gg          , Rd          , Gg          , Gg          , Gg          , Gg          , Hh          , Hh^Fmf      
