border_size=1
usage=map

Wo          , Wo          , Wo          , Wo          , Wo          , Wo          , Wo          , Wo          , Wo          , Wo          , Wo          , Ww          , Ww          , Ww          , Ds          , Ds          , Ds          , Gg          , Gg          , Gs^Fp       , Gg          , Gs^Fp       
Wo          , Wo          , Wo          , Wo          , Wo          , Wo          , Wo          , Wo          , Wo          , Wo          , Wo          , Wo          , Ww          , Ww          , Ds          , Ds          , Dd^Vdt      , Ch          , Ch          , Gg          , Gg          , Gs^Fp       
Wo          , Wo          , Wo          , Wo          , Wo          , Wo          , Wo          , Wo^Bw\      , Gg^Vh       , Wo          , Wo          , Wo          , Wo          , Ww          , Ds          , Ds          , Ch          , 2 Kh        , Ch          , Gg          , Gg          , Gs^Fp       
Wo          , Wo          , Wo          , Wo          , Wo          , Wo^Bw\      , Gg^Vh       , Gg          , Gg          , Ds          , Wo          , Wo          , Wo          , Ww          , Ww          , Ds          , Gg          , Ch          , Gg          , Gg          , Gg          , Gs^Fp       
Wo          , Wo          , Wo^Bw\      , Wo          , Gg          , Gg          , Gg          , Gg          , Gs^Ft       , Ds          , Wo          , Wo          , Wo          , Ww          , Ww          , Ds          , Ww          , Gg          , Gg          , Gg          , Gg          , Gs^Fp       
Wo          , Wo          , Wo          , Gg^Vh       , Gg          , Gg          , Ch          , Gg          , Gg          , Ds          , Wo          , Wo          , Wo          , Ww          , Ww          , Ww          , Ww          , Ww          , Ww          , Gg^Vh       , Ww          , Gs^Fp       
Wo          , Wo          , Wo          , Ds          , Gg          , Ch          , 3 Kh        , Chw         , Ww          , Wo          , Wo          , Wo          , Wo          , Ww          , Ds          , Ds          , Gg          , Ww          , Ww          , Ww          , Ww          , Ww          
Wo          , Wo          , Wo          , Ds          , Gg          , Ch          , Ch          , Ch          , Wwr         , Wo          , Wo          , Wo          , Ww^Vm       , Ww          , Ds          , Ds          , Gg          , Gg          , Gg          , Ww          , Gg          , Ww          
Wo          , Wo          , Wo          , Ds          , Gg          , Ch          , Ww          , Ww          , Wwr         , Ww          , Wo          , Wo          , Ww          , Ww          , Ds          , Gg          , Gg          , Gg^Vh       , Gg          , Gg          , Gg          , Gg          
Wo          , Wo          , Ww          , Ds          , Ww          , Ww          , Wwr         , Ww          , Ww          , Ww          , Wo          , Wo          , Ww          , Ww          , Ds          , Gg          , Gg          , Gg          , Gg          , Gg          , Gg          , Gg          
Wo          , Wwr         , Wwr         , Ww          , Wwr         , Wwr         , Wwr         , Wwr         , Ww          , Wo          , Wo          , Wo          , Ww          , Ds          , Ds          , Gg          , Gg          , Gg          , Gg          , Gg          , Gg          , Gg          
Wo          , Wo          , Ww          , Wwr         , Ww          , Wwr         , Ww          , Ww^Vm       , Ww          , Wo          , Wo          , Wo          , Ww          , Ds          , Re          , Gg          , Gg          , Gg          , Gg          , Gg          , Gg          , Re          
Wo          , Ww          , Ww          , Ww          , Ww^Vm       , Ww          , Wwr         , Wwr         , Ww          , Wo          , Wo          , Wo          , Ww          , Ds          , Re          , Gg^Vh       , Gg          , Gg          , Gg          , Gg          , Gg          , Re          
Wo          , Ww          , Ww          , Wwr         , Wwr         , Wwr         , Ww          , Ww          , Ww          , Wo          , Ww          , Ww          , Ds          , Dd^Do       , Gg          , Gg          , Gg          , Gg          , Gg          , Gg          , Re          , Re          
Wo          , Wo          , Wo          , Wwr         , Ww          , Ww          , Ww          , Ww          , Ww          , Ww          , Ds          , Ds          , Gg          , Gg          , Gg          , Gg          , Gg          , Gg          , Gg          , Re          , Re          , Re          
Wo          , Wo          , Wo          , Wo          , Ww          , Ww          , Ww          , Ds          , Ds          , Ds          , Gg          , Gg^Vh       , Gg          , Gg          , Gg          , Gg          , Hh          , Hh          , Re          , Re          , Gg          , Gg          
Wo          , Wo          , Wo          , Wo          , Wo          , Ds          , Ds          , Ds          , Gg          , Gg          , Gg          , Gg          , Gg          , Gg          , Gg          , Hh          , Hh          , Gg          , Re          , Gg          , Gg          , Gg          
Wo          , Wo          , Wo          , Wo          , Ww          , Ds          , Gg^Vh       , Gg          , Gg          , Gg          , Gg          , Gg          , Gg          , Gg          , Hh          , Hh          , Gg          , Gg          , Ce          , Ce          , Gg          , Gg          
Wo          , Wo          , Ce          , Ce          , Ce          , Ww          , Gg          , Gg          , Gg          , Gg          , Gg          , Gg^Vh       , Gg          , Gg          , Hh          , Hh          , Gg          , Ce          , Ce          , 1 Ke        , Gg          , Gg          
Wo          , Wo          , Ce          , 4 Ke        , Ce          , Ww          , Wwf         , Gg          , Gg          , Gg          , Gg          , Gg          , Hh          , Hh          , Hh          , Hh^Vhh      , Gg          , Gg          , Gg          , Ce          , Gg          , Gg          
Gs^Ft       , Gs^Vht      , Gs^Fds      , Ce          , Gs^Fds      , Wwf         , Ww          , Gg          , Gg          , Gg          , Gg          , Gg          , Hh          , Hh          , Hh          , Hh          , Gg          , Gg          , Gg          , Gg          , Gg          , Gs^Fp       
Gs^Ft       , Gs^Ft       , Gs^Ft       , Gs^Ft       , Gs^Fds      , Gs^Ft       , Ww          , Gg          , Gg          , Gg          , Gg          , Hh^Fms      , Hh          , Hh          , Hh^Fms      , Hh          , Hh          , Hh          , Hh^Fms      , Hh^Fms      , Hh^Fms      , Hh^Fms      
