border_size=1
usage=map

Wo          , Wo          , Ww          , Ww          , Ww          , Wwr         , Wwr         , Hd          , Ds          , Ds          , Ds          , Ds          , Xu          , Xu          , Xu          , Xu          , Xu          , Xu          , Xu          , Xu          , Xu          , Xu          , Xu          , Ww          , Xu          , Xu          , Xu          , Xu          , Xu          , Xu          , Qxu         , Qxu^Bs|     , Qxu         , Qxu         
Wo          , Wo          , Hd          , Ww          , Ww          , Ww          , Ww          , Dd^Do       , Gg          , Gs^Fp       , Gs^Fp       , Xu          , Xu          , Xu          , Xu          , Xu          , Xu          , Xu          , Xu          , Xu          , Xu          , Xu          , Xu          , Ww          , Xu          , Xu          , Xu          , Xu          , Xu          , Qxu         , Qxu         , Qxu^Bs|     , Qxu         , Qxu         
Wo          , Wo          , Dd          , Ww          , Ww          , Ww          , Ww          , Ww          , Gg          , Gs^Fp       , Gs^Fp       , Xu          , Xu          , Xu          , Uu^Vu       , Xu          , Uu^Uf       , Xu          , Uh          , Xu          , Xu          , Xu          , Xu          , Ww          , Uu^Uf       , Xu          , Uu          , Xu          , Uu^Uf       , Qxu         , Qxu         , Cud         , Qxu         , Qxu         
Wo          , Wo          , Ds          , Dd^Do       , Gg          , Ww          , Gg          , Ww          , Gg          , Gs^Fds      , Gs^Fds      , Xu          , Xu          , Xu          , Xu          , Uu          , Uu          , Uu          , Uu          , Uh          , Uh          , Xu          , Ur          , Wwf         , Wwf         , Ur          , Cud         , Uu          , Uu          , Uu^Uf       , Uu          , Qxu         , Ww          , Ww          
Wo          , Wo          , Ds          , Ds          , Gg          , Gg          , Gg          , Gg          , Gg          , Gs^Fds      , Gs^Fds      , Xu          , Xu          , Xu          , Xu          , Uu^Uf       , Uu          , Uu          , Ur          , Ur          , Ur          , Ur          , Xu          , Xu          , Uu^Vu       , Ww          , Ww          , Cud         , Cud         , Uu^Uf       , Uu          , Uh          , Ww          , Xu          
Wwr         , Wo          , Ww          , Ds          , Gg          , Gg          , Gg          , Gg          , Gg          , Gs^Fds      , Gg          , Gg          , Xu          , Xu          , Xu          , Xu          , Ur          , Ur          , Uu          , Uu          , Uu          , Uu          , Uh          , Xu          , Xu          , Uu^Uf       , Xu          , Ww          , Ww          , 3 Kud       , Ww          , Ww          , Uu^Uf       , Xu          
Wo          , Wwr         , Ww          , Ds          , Gg          , Gg          , Gg          , Gg          , Gg          , Gg          , Gg          , Gg          , Xos         , Xu          , Ur          , Ur          , Xu          , Uu          , Uu^Uf       , Uu          , Uu^Vu       , Uh          , Xu          , Xu          , Xu          , Xu          , Hh^Fp       , Xu          , Xu          , Ww          , Xu          , Uu^Vu       , Xu          , Xu          
Wwr         , Wwr         , Ww          , Ds          , Gg          , Gg          , Gg          , Gg          , Gg          , Gg          , Gg          , Re          , Rd          , Ur          , Xu          , Xu          , Xu          , Xu          , Xu          , Xu          , Xu          , Xu          , Xu          , Xu          , Xu          , Xu          , Hh^Fp       , Xu          , Hh^Fp       , Xu          , Hh^Fp       , Xu          , Gs^Fp       , Gs^Fp       
Wwr         , Wwr         , Ds          , Ds          , Re          , Gg          , Re          , Gg          , Gg          , Gg          , Gg          , Re          , Rd          , Xos         , Xu          , Xu          , Xu          , Xu          , Xu          , Xu          , Xu          , Xu          , Xu          , Xu          , Hh^Fp       , Hh^Fp       , Hh^Fp       , Hh^Fp       , Hh^Fp       , Hh^Fp       , Gs^Fp       , Gs^Fp       , Gs^Fp       , Gs^Fp       
Wo          , Wwr         , Wo          , Re          , Ww          , Re          , Ww          , Re          , Re          , Gg          , Re          , Re          , Rd          , Re          , Re          , Hh^Fp       , Hh^Fp       , Xu          , Xu          , Xu          , Hh^Fp       , Hh^Fp       , Hh^Fp       , Hh^Fp       , Hh^Fp       , Hh^Fp       , Gs^Fp       , Hh^Fp       , Gs^Fp       , Gs^Fp       , Gs^Fp       , Gs^Fp       , Gs^Fp       , Gs^Fp       
Wo          , Wo          , Wo          , Ww          , Re          , Ww          , Re          , Ww          , Ww          , Re          , Ww          , Re          , Rd          , Re          , Re          , Hh^Fp       , Hh^Fp       , Hh^Fp       , Hh^Fp       , Hh^Fp       , Gs^Fp       , Hh^Fp       , Hh^Fp       , Hh^Fp       , Gs^Fp       , Gs^Fp       , Gs^Fp       , Gs^Fp       , Ww          , Ww          , Ww          , Ww          , Ww          , Gs^Fp       
Wo          , Wo          , Gg          , Gg          , Gg          , Re          , Gg          , Re          , Re          , Ww          , Re          , Wwf         , Wwf         , Re          , Re          , Hh^Fp       , Gs^Fp       , Gs^Fp       , Gs^Fp       , Gs^Fp       , Gs^Fp       , Gs^Fp       , Gs^Fp       , Gs^Fp       , Gs^Fp       , Gs^Fp       , Ww          , Ww          , Gg          , Gg^Fet      , Ww          , Ww          , Ww          , Gs^Fp       
Wo          , Wo          , Gg          , Gg          , Gg          , Gg          , Gg^Vh       , Gg          , Gg          , Re          , Re          , Wwf         , Re          , Wwf         , Wwf         , Ww          , Ww          , Gs^Fp       , Ww          , Gs^Fp       , Ww          , Gs^Fp       , Ww          , Ww          , Ww          , Ww          , Re          , Re^Vct      , Re^Gvs      , Gg          , Gg          , Ww          , Ww          , Ww          
Wo          , Wo          , Gg          , Gg          , Re^Gvs      , Re^Gvs      , Re^Gvs      , Gg          , Gg          , Gg          , Gg          , Re          , Re          , Rd          , Re          , Re          , Re          , Ww          , Re          , Ww          , Re          , Ww          , Re          , Re          , Re          , Re          , Re^Gvs      , Re^Gvs      , Re^Gvs      , Gg          , Gg          , Gg          , Ww          , Ww          
Wo          , Wo          , Ww          , Ggf         , Ggf         , Re^Gvs      , Re^Gvs      , Re^Gvs      , Gg          , Gg          , Gg          , Gg          , Chr         , Chr         , 1 Kh        , Gg          , Gg          , Re          , Re          , Re          , Gg          , Re          , Gg          , Re          , Re^Gvs      , Re^Gvs      , Re^Gvs      , Re^Gvs      , Re^Gvs      , Gg          , Gg^Vh       , Gg          , Ww          , Ww          
Wo          , Wo          , Ww          , Ww          , Ww          , Ggf         , Gg          , Gg          , Gg          , Gg          , Chr         , Chr         , Rp^Vhc      , Gg          , Rp^Vhc      , Chr         , Gg          , Gg          , Gg          , Re          , Gg          , Gg^Vh       , Re^Gvs      , Re^Gvs      , Re^Gvs      , Re^Gvs      , Re^Gvs      , Re^Gvs      , Re^Gvs      , Gg          , Gg          , Gg          , Ww          , Ww          
Wo          , Wo          , Wo          , Ww          , Gg^Vh       , Ggf         , Gg          , Gg^Wm       , Gg          , Chr         , Gg          , Rp          , Rp          , Gg          , Rp          , Chr         , Gg          , Gg          , Gg          , Re          , Re^Gvs      , Re^Gvs      , Re^Gvs      , Re^Gvs      , Re^Gvs      , Re^Gvs      , Re^Gvs      , Re^Gvs      , Re          , Re          , Gg          , Gg          , Gg          , Ww          
Wo          , Wo          , Wo          , Ww          , Gg          , Gg          , Gg          , Gg          , Gg          , Chr         , Gg          , Rp^Vhc      , Gg^Fet      , Rp          , Ggf         , Chr         , Rd          , Gg          , Gg          , Re^Gvs      , Re^Gvs      , Re^Gvs      , Re^Gvs      , Re          , Re^Gvs      , Re^Gvs      , Re          , Re          , Gg          , Gg          , Ss          , Gg          , Ww          , Ww          
Wo          , Wo          , Ww          , Ww          , Re^Gvs      , Re^Gvs      , Re^Gvs      , Gg          , Gg          , Chr         , Rp^Vhc      , Rp          , Rp^Vhc      , Rp          , Chr         , Chr         , Gg          , Rd          , Re          , Re^Gvs      , Re^Gvs      , Re^Gvs      , Re^Gvs      , Re^Gvs      , Re          , Re          , Gg          , Gg          , Gg          , Ss          , Ss          , Ss          , Ww          , Ww          
Wo          , Wo          , Ww          , Gg          , Re^Gvs      , Re^Gvs      , Re^Gvs      , Gg          , Gg          , 2 Kh        , Chr         , Gg          , Chr         , Chr         , Gg          , Gg          , Gg          , Rd          , Rd          , Re          , Re          , Re^Gvs      , Re          , Re          , Re^Gvs      , Re^Gvs      , Gg          , Gg          , Gg          , Ss          , Ss          , Ss          , Gg          , Ww          
Wo          , Wo          , Ww          , Gg          , Gg          , Re^Gvs      , Gg          , Gg          , Gg          , Gg          , Gg          , Chr         , Gg          , Gg          , Re^Gvs      , Re^Gvs      , Re          , Gg          , Rd          , Re          , Gg^Wm       , Re          , Re^Gvs      , Re^Gvs      , Gg          , Gg          , Gg          , Gg          , Gg          , Gg          , Ss          , Gg          , Ww          , Ww          
Wo          , Wo          , Gg          , Ww          , Gg          , Gg          , Gg          , Gg^Vh       , Gg          , Gg          , Gg          , Chr         , Gg          , Re^Gvs      , Re          , Re          , Re          , Re          , Rd          , Gg          , Gg          , Gg          , Gg          , Gg          , Gg          , Gg^Vh       , Gg          , Gg          , Gg          , Ss          , Ss          , Ss          , Ww          , Ww          
Wo          , Wo          , Wo          , Ww          , Ww          , Gg          , Gg          , Gg          , Gg          , Gg          , Chr         , Chr         , Gg          , Gg          , Gg          , Re          , Re          , Re          , Rd          , Gg          , Gg          , Gg          , Ss          , Gg          , Gg          , Gg          , Gg          , Gg          , Gg          , Ss          , Ss          , Ss          , Ww          , Ww          
Wo          , Wo          , Wo          , Ww          , Ww          , Ww^Bw/      , Ww          , Gg          , Chw         , Chr         , Gg          , Gg          , Gg          , Gg          , Gg          , Gg          , Gg          , Gg          , Rd          , Gg          , Gg          , Ss          , Ss          , Ss          , Ss          , Gg          , Ss          , Ss          , Ss          , Ss          , Ss          , Ss          , Ww          , Ww          
Wo          , Wo          , Wo          , Wo          , Wo          , Ww          , Wo          , Ww          , Ww          , Ww          , Ww^Bw/      , Gg          , Ww^Bw\      , Ww          , Ww          , Gg          , Ww          , Gg          , Rd          , Gg          , Gg          , Ss          , Ss          , Ss          , Ss          , Ss          , Ss          , Ss          , Ss          , Ss          , Ss          , Ss          , Ss          , Ww          
Wo          , Wo          , Wo          , Wo          , Wo          , Wo          , Wo          , Wo          , Wo          , Wo          , Wo          , Ww          , Wo          , Wo          , Wo          , Ww          , Wo          , Wo          , Wo^Bw|      , Wo          , Wo          , Ww          , Ww          , Ss          , Ss          , Ss          , Ww          , Ss          , Ss          , Ss          , Ss          , Ss^Vhs      , Ww          , Ww          
Wo          , Wo          , Wo          , Wo          , Wo          , Wo          , Wo          , Wo          , Wo          , Wo          , Wo          , Wo          , Wo          , Wo          , Wo          , Wo          , Wo          , Wo          , Hd          , Wo          , Wo          , Wo          , Wo          , Ww          , Ww          , Ww          , Wo          , Ww          , Ww          , Ss          , Ww          , Ss          , Ww          , Ww          
Wo          , Wo          , Dd          , Wo          , Wo          , Wo          , Wo          , Wo          , Ww          , Wo          , Wo          , Wo          , Wo          , Wo          , Ww          , Wo          , Hd          , Wo^Bw/      , Wo          , Dd^Vda      , Wo          , Wo          , Wo          , Wo          , Wo          , Wo          , Wo          , Wo          , Wo          , Wo          , Wo          , Wo          , Wo          , Ww          
Dd          , Dd          , Gs          , Dd          , Dd          , Wo          , Dd          , Ww          , Chw         , Ww          , Ww          , Wo          , Ww          , Ww          , Rd          , Wo^Bw/      , Ww          , Wo          , Wo          , Wo          , Wo          , Wo          , Ww          , Ww          , Ww          , Wo          , Wo          , Wo          , Wo          , Wo          , Wo          , Wo          , Wo          , Wo          
Gs          , Gs          , Gs^Fms      , Gs          , Gs          , Dd          , Gg^Vh       , Dd          , Ch          , Dd          , Dd          , Ww          , Rd          , Rd          , Gg          , Gg          , Ss          , Ww          , Ww          , Ww          , Ww          , Ww          , Ss          , Ww          , Ss          , Ww          , Ww          , Wo          , Wo          , Wo          , Ww          , Wo          , Wo          , Wo          
Gs^Fms      , Gs^Fms      , Gs          , Gs          , Gs          , Gs          , Ggf         , Ggf         , Ch          , Gg          , Gg          , Dd          , Rd          , Gg^Vh       , Gg          , Ss          , Ss          , Ss          , Ss          , Ss          , Ss          , Ss          , Ss          , Ss          , Ss          , Ss          , Ss          , Ww          , Ss          , Ww          , Ss          , Ww          , Ww          , Ww          
Gs          , Gs^Fms      , Gs          , Gs          , Dd^Do       , Gs          , Gs          , Ggf         , Ch          , Gg          , Gg          , Rd          , Rd          , Gg          , Gg          , Ss          , Ss          , Ss          , Ss          , Ss          , Ss          , Gg          , Gg          , Ss          , Ss          , Ss^Vhs      , Ss          , Ss          , Ss          , Ss          , Ss^Vhs      , Ss          , Ss          , Ss          
Gs          , Gs          , Gs^Fms      , Gs          , Gs          , Gs          , Gs          , Ch          , 5 Kh        , Ch          , Rd          , Rd          , Gg          , Gg          , Gg          , Gg          , Gg          , Gg          , Gg          , Ss          , Gg          , Gg          , Gg          , Gg          , Gg          , Ss          , Gg          , Ss          , Ss          , Ss          , Ss          , Ss          , Ss          , Ss          
Gs          , Gs          , Gs^Fms      , Gs          , Gs          , Gs          , Gs          , Ch          , Ch          , Ch          , Gs          , Gs          , Gs          , Gg          , Gg          , Gg          , Gg          , Gg          , Gg          , Gg          , Gg          , Gg          , Gg          , Gg          , Gg          , Gg          , Gg          , Gg          , Ce          , Gg          , Gg          , Gg          , Gg          , Ss          
Gs          , Gs          , Ggf         , Gs^Fms      , Gs          , Gs          , Gs          , Gs          , Gs          , Gs          , Dd          , Gs          , Gg          , Gg          , Gg^Vh       , Gg          , Gg          , Gg          , Gg          , Gg          , Gg          , Gg          , Gg          , Gg          , Gg          , Gg          , Gg          , Ce          , 4 Ke        , Re^Vct      , Gg          , Gg          , Ww          , Ss          
Gs          , Gs          , Gs          , Gs          , Gs          , Gs          , Gs^Vht      , Gs          , Gs          , Dd          , Gs          , Gg          , Gg          , Gg          , Gg          , Gg          , Gg          , Gg          , Gg          , Gg          , Gg          , Gg          , Gg          , Gg          , Gg          , Gg          , Gg          , Ce          , Ce          , Ce          , Gg          , Gg          , Ss          , Ww          
Gs          , Gs          , Gs          , Gs^Vht      , Gs          , Gs          , Gs          , Gs          , Dd          , Dd          , Hd          , Hh          , Gg          , Gg          , Hh^Fdw      , Gg          , Gg          , Gg          , Gg          , Gg          , Gg          , Gg          , Gg          , Gg          , Gg          , Gg          , Gg          , Gg          , Gg          , Gg          , Gg          , Gg          , Ss          , Ww          
Ggf         , Gs          , Gs          , Gs          , Gs          , Gs          , Dd          , Dd          , Hd          , Hd          , Hd          , Hh          , Hh          , Hh^Fdw      , Hh^Fdw      , Gg          , Gg          , Gs^Fds      , Gs^Fds      , Gs^Fds      , Gg          , Gg          , Gg          , Ww          , Gg          , Gg          , Gg          , Gg          , Gg          , Gg          , Gg          , Gg          , Ss          , Ww          
