border_size=1
usage=map

Md^Xm       , Md^Xm       , Md^Xm       , Md^Xm       , Md^Xm       , Md^Xm       , Md^Xm       , Md^Xm       , Md^Xm       , Md^Xm       , Md^Xm       , Md^Xm       , Md^Xm       , Md^Xm       , Md^Xm       , Md^Xm       , Dd          , Dd          , Dd          , Dd          
Md^Xm       , Ds          , Md^Xm       , Md^Xm       , Md^Xm       , Md^Xm       , Md^Xm       , Md^Xm       , Md^Xm       , Md^Xm       , Md^Xm       , Md^Xm       , Md^Xm       , Md^Xm       , Md^Xm       , Md^Xm       , Md^Xm       , Md^Xm       , Md^Xm       , Md^Xm       
Md^Xm       , Md^Xm       , Md^Xm       , Md^Xm       , Md^Xm       , Md^Xm       , Md^Xm       , Md^Xm       , Md^Xm       , Md^Xm       , Md^Xm       , Md^Xm       , Md^Xm       , Md^Xm       , Md^Xm       , Md^Xm       , Md^Xm       , Md^Xm       , Md^Xm       , Md^Xm       
Md^Xm       , Md^Xm       , Md^Xm       , Md^Xm       , Md^Xm       , Md^Xm       , Md^Xm       , Md^Xm       , Dd          , Md^Xm       , Md^Xm       , Md^Xm       , Md^Xm       , Md^Xm       , Md^Xm       , Md^Xm       , Md^Xm       , Md^Xm       , Md^Xm       , Md^Xm       
Dd          , Md^Xm       , Md^Xm       , Md^Xm       , Md^Xm       , Md^Xm       , Md^Xm       , Dd          , Dd          , Dd          , Dd          , Hd          , Ds          , Hd          , Hd          , Hd          , Hd          , Dd          , Dd          , Dd          
Dd          , Dd          , Dd          , Dd          , Dd          , Md^Xm       , Dd          , Dd          , Dd          , Dd          , Ds          , Ds          , Rd          , Ds          , Ds          , Hd          , Hd          , Hd          , Hd          , Hd          
Dd          , Dd          , Dd          , Dd          , Dd          , Dd          , Dd          , Dd          , Ds          , Ds          , Rd          , Rd          , Ql          , Rd          , Rd          , Ds          , Ds          , Hd          , Hd          , Hd          
Ds          , Dd          , Ds          , Dd          , Ds          , Dd          , Ds          , Ds          , Rd          , Rd          , Ql          , Ql          , Cud         , Ql          , Ql          , Rd          , Rd          , Ds          , Ds          , Hd          
Ds          , Ds          , Ds          , Ds          , Ds          , Ds          , Rd          , Rd          , Ql          , Ql          , Cud         , Cud         , Dd^Do       , Cud         , Cud         , Ql          , Ql          , Rd          , Rd          , Ds          
Ds          , Ds          , Ds          , Ds          , Ds          , Ds          , Ds          , Rd          , Rd          , Ql          , Ql          , Cud         , Cud         , Cud         , Ql          , Ql          , Rd          , Rd          , Ds          , Ds          
Dd          , Dd          , Dd          , Dd          , Dd          , Dd          , Dd          , Ds          , Ds          , Rd          , Rd          , Ql          , Ql          , Ql          , Rd          , Rd          , Ds          , Ds          , Hd          , Hd          
Dd          , Dd          , Dd          , Dd          , Dd          , Dd          , Dd          , Dd          , Dd          , Ds          , Ds          , Rd          , Rd          , Rd          , Ds          , Ds          , Dd          , Dd          , Dd          , Hd          
Dd          , Dd          , Dd          , Dd          , Dd          , Dd          , Dd          , Dd          , Dd          , Dd          , Dd          , Ds          , Ds          , Ds          , Dd          , Dd^Do       , Dd          , Dd          , Dd          , Dd          
Dd          , Dd          , Dd          , Dd          , Dd          , Dd          , Dd          , Dd          , Dd          , Dd          , Dd          , Ds          , Ds          , Ds          , Dd          , Dd          , Dd          , Dd          , Dd          , Dd          
Dd          , Dd          , Dd          , Dd          , Dd          , Dd          , Dd          , Dd          , Dd          , Dd          , Dd          , Ds          , Ds          , Ds          , Dd          , Dd          , Dd          , Hd          , Dd          , Dd          
Dd          , Dd          , Dd          , Dd          , Dd          , Dd          , Dd          , Dd          , Dd          , Dd          , Dd          , Ds          , 1 Ds        , Ds          , Dd          , Dd          , Dd          , Dd          , Dd          , Dd          
Md^Xm       , Md^Xm       , Md^Xm       , Dd          , Dd          , Dd          , Dd          , Dd          , Dd          , Dd          , Dd          , Ds          , Ds          , Ds          , Dd          , Dd          , Dd          , Dd          , Dd          , Dd          
Md^Xm       , Md^Xm       , Md^Xm       , Md^Xm       , Md^Xm       , Dd          , Dd          , Dd          , Dd          , Dd          , Md^Xm       , Dd          , Md^Xm       , Ds          , Md^Xm       , Dd          , Md^Xm       , Dd          , Md^Xm       , Dd          
Md^Xm       , 2 Ds        , Md^Xm       , Md^Xm       , Md^Xm       , Md^Xm       , Md^Xm       , Md^Xm       , Md^Xm       , Md^Xm       , Md^Xm       , Md^Xm       , Md^Xm       , Md^Xm       , Md^Xm       , Md^Xm       , Md^Xm       , Md^Xm       , Md^Xm       , Md^Xm       
Md^Xm       , Md^Xm       , Md^Xm       , Md^Xm       , Md^Xm       , Md^Xm       , Md^Xm       , Md^Xm       , Md^Xm       , Md^Xm       , Md^Xm       , Md^Xm       , Md^Xm       , Md^Xm       , Md^Xm       , Md^Xm       , Md^Xm       , Md^Xm       , Md^Xm       , Md^Xm       
