border_size=1
usage=map

Xu          , Xu          , Xu          , Xu          , Xu          , Xu          , Wwf         , Xu          , Xu          , Xu          , Xu          , Xu          , Xu          , Xu          , Xu          , Xu          , Xu          , Xu          , Ur          , Xu          , Xu          , Xu          , Xu          , Xu          , Xu          , Xu          , Xu          , Xu          , Xu          , Xu          
Xu          , Xu          , Xu          , Xu          , Xu          , Xu          , Wwf         , Xu          , Xu          , Xu          , Xu          , Xu          , Xu          , Xu          , Xu          , Xu          , Xu          , Xu          , Ur          , Xu          , Xu          , Xu          , Xu          , Xu          , Xu          , Xu          , Xu          , Xu          , Xu          , Xu          
Xu          , Xu          , Xu          , Xu          , Xu          , Xu          , Gs^Fp       , Gs^Fp       , Gs          , Xu          , Xu          , Xu          , Xu          , Xu          , Ur          , Ur          , Ur          , Xu          , Ur          , Xu          , Ur          , Ur          , Xu          , Xu          , Xu          , Xu          , Xu          , Xu          , Xu          , Xu          
Xu          , Xu          , Xu          , Xu          , Gs^Fp       , Gs^Fp       , Re^Gvs      , Gs          , Gs          , Gs          , Re          , Xu          , Ur          , Ur          , Xu          , Xu          , Xu          , Ur          , Ur          , Ur          , Xu          , Ur          , Xu          , Xu          , Dd          , Dd^Dc       , Dd          , Xu          , Xu          , Xu          
Xu          , Xu          , Xu          , Xu          , Xu          , Gs          , Gs          , Gs          , Xu          , Xu          , Ur^Ii       , Ur^Ii       , Xu          , Xu          , Ur          , Xu          , Xu          , Xu          , Ur          , Xu          , Xu          , Ur          , Xu          , Xu          , Xu          , Dd          , Xu          , Xu          , Ur          , Ur          
Xu          , Xu          , Xu          , Xu          , Xu          , Xu          , Xu          , Xu          , Ur          , Ur          , Xu          , Re          , Xu          , Xu          , Ur          , Xu          , Xu          , Xu          , Ur          , Xu          , Xu          , Ur          , Xu          , Xu          , Xu          , Ur          , Ur          , Ur          , Xu          , Xu          
Xu          , Xu          , Xu          , Xu          , Uu^Ufi      , Xu          , Ur          , Ur          , Xu          , Xu          , Gs          , Re^Ii       , Xu          , Xu          , Ur          , Xu          , Xu          , Xu          , Ur          , Xu          , Xu          , Ur          , Xu          , Xu          , Ur          , Ur          , Xu          , Xu          , Xu          , Xu          
Xu          , Xu          , Xu          , Uu^Ufi      , Ur          , Ur          , Xu          , Xu          , Re          , Re          , Re^Gvs      , Gg          , Xu          , Xu          , Ur          , Xu          , Xu          , Xu          , Ur          , Xu          , Xu          , Ur          , Ur          , Ur          , Xu          , Xu          , Xu          , Xu          , Xu          , Xu          
Ur          , Xu          , Ur          , Ur          , Xu          , Xu          , Re          , Re          , Re^Gvs      , Re^Gvs      , Gg          , Gg          , Xu          , Xu          , Ur          , Xu          , Xu          , Xu          , Cud         , Xu          , Xu          , Xu          , Xu          , Xu          , Xu          , Xu          , Xu          , Xu          , Xu          , Xu          
Xu          , Ur          , Xu          , Xu          , Xu          , Gs          , Re^Gvs      , Re^Gvs      , Re          , Re          , Xu          , Xu          , Ur          , Ur          , Ur          , Ur          , Xu          , Xu          , Kud         , Xu          , Xu          , Xu          , Xu          , Xu          , Wo          , Xu          , Xu          , Xu          , Xu          , Xu          
Xu          , Xu          , Xu          , Xu          , Xu          , Xu          , Xu          , Re          , Xu          , Xu          , Ur          , Ur          , Ur          , Ur          , Xu          , Xu          , Xu          , Xu          , Cud         , Cud         , Cud         , Xu          , Wo          , Wo          , Xu          , Xu          , Xu          , Xu          , Xu          , Xu          
Xu          , Xu          , Xu          , Xu          , Xu          , Xu          , Xu          , Xu          , Ur          , Ur          , Ur          , Ur          , Xu          , Xu          , Qxu         , Uu^Xo       , Rr          , Cud         , Xu          , Xu          , Xu          , Xu          , Xu          , Xu          , Xu          , Xu          , Xu          , Xu          , Xu          , Xu          
Dd          , Xu          , Xu          , Xu          , Dd          , Hd          , Xu          , 2 Hd        , Ur          , Ur          , Xu          , Xu          , Qxu         , Qxu         , Rr          , Qxu^Bs/     , Qxu         , Xu          , Xu          , Xu          , Dd^Dr       , Xu          , Dd          , Xu          , Dd          , Xu          , Xu          , Xu          , Xu          , Xu          
Dd          , Dd          , Dd          , Dd          , Dd          , Dd          , Dd          , Xu          , Xu          , Xu          , Qxu         , Qxu         , Rr          , Rr          , Qxu         , Qxu         , Xu          , Xu          , Dd          , Dd          , Hd          , Dd          , Dd          , Dd          , Dd          , Dd          , Dd          , Xu          , Dd          , Xu          
Dd          , Dd          , Dd          , Dd          , Md^Xm       , Dd          , Dd          , Md^Xm       , Md^Xm       , Xu          , Rd          , Rr          , Rr          , Qxu         , Xu          , Xu          , Dd          , Dd          , Dd          , Ds          , Ds          , Dd^Do       , Hd          , Dd          , Dd          , Dd          , Dd          , Dd          , Dd          , Hd          
Dd          , Dd          , Dd          , Md^Xm       , Dd          , Md^Xm       , Md^Xm       , Md^Xm       , Rd          , Rd          , Hd          , Hd          , Hd          , Rr          , Rr          , Dd          , Dd          , Dd          , Dd          , Dd          , Dd          , Ds          , Dd          , Hd          , Hd          , Dd          , Dd          , Dd          , Xu          , Xu          
Dd          , Dd          , Dd          , Dd^Dr       , Dd          , Dd          , Rd          , Rd          , Dd          , Dd^Dc       , Dd          , Hd          , Dd          , Dd          , Dd          , Rr          , Rr          , Dd          , Dd          , Hd          , Dd          , Dd          , Dd          , Dd^Dc       , Rr          , Hd          , Hd          , Xu          , Xu          , Xu          
Dd          , Dd          , Dd          , Dd          , Rd          , Rd          , Dd          , Dd          , Dd          , Dd          , Dd          , Dd          , Dd          , Dd          , Dd          , Dd          , Dd          , Rr          , Rr          , Dd          , Dd          , Dd          , Rr          , Rr          , Dd          , Rr^Dr       , 1 Rr        , Xu          , Uu^Vu       , Xu          
Dd^Dc       , Dd          , Rd          , Rd          , Dd          , Dd          , Dd          , Dd          , Dd          , Dd          , Dd          , Dd          , Dd          , Dd          , Dd          , Dd          , Dd          , Dd          , Dd          , Rr          , Rr          , Rr          , Dd          , Dd          , Dd          , Dd          , Xu          , Rr          , Rr          , Xu          
Rd          , Rd          , Dd          , Dd          , Dd          , Dd          , Dd          , Hd          , Hd          , Dd          , Dd          , Dd          , Dd          , Dd          , Dd          , Dd          , Dd          , Dd          , Dd          , Dd          , Dd          , Dd          , Dd          , Dd          , Xu          , Xu          , Xu          , Xu          , Xu          , Rr          
