border_size=1
usage=map

Ms          , Ms          , Ms          , Ms          , Ms          , Ms          , Ms          , Ms          , Ms          , Ms          , Ms          , Ms          , Ms          , Ms          , Ms          , Ms          , Ai          , Ai          , Ai          , Ai          
Ms          , Ms          , Ms          , Ms          , Ms          , Ms          , Ms          , 2 Ms        , Ms          , Ms          , Ms          , Ms          , Ms          , Ms          , Ms          , Ms          , Ms          , Ai          , Ai          , Ai          
Ms          , Ms          , Ms          , Ms          , Ms          , Ms          , Ms          , Ms          , Ms          , Ms          , Ms          , Ms          , Ms          , Ms          , Ms          , Ms          , Ms          , Ms          , Ai          , Ai          
Ms          , Ms          , Ms          , Ms          , Ms          , Ms          , Ms          , Ms          , Ha          , Ms          , Ms          , Ms          , Ms          , Ms          , Ms          , Ms          , Ms          , Ms          , Ai          , Ai          
Ha          , Ms          , Ms          , Ms          , Ms          , Ms          , Ms          , Ha          , Ha          , Ha          , Ha          , Aa^Fda      , Aa          , Ha          , Ha          , Ha          , Ha          , Ha          , Ha          , Ai          
Ha          , Ha          , Ha          , Ha          , Ha          , Ms          , Ha          , Ha          , Ha          , Ha          , Aa          , Aa          , Rd          , Aa          , Aa          , Ha          , Ha          , Ha          , Ha          , Ha          
Xu          , Xu          , Aa          , Ha          , Ha          , Ha          , Ha          , Ha          , Aa          , Aa          , Rd          , Rd          , Hd          , Rd          , Rd          , Aa          , Aa          , Ha          , Ha          , Ha          
Ur          , Ur          , Aa          , Ha          , Aa          , Ha          , Aa          , Aa          , Rd          , Rd          , Hd          , Hd          , Chw         , Hd          , Hd          , Rd          , Rd          , Aa          , Aa          , Ha          
Ur          , Ur          , Ur          , Aa          , Aa          , Aa          , Rd          , Rd          , Hd          , Hd          , Chw         , Chw         , Dd^Do       , Chw         , Chw         , Hd          , Hd          , Rd          , Rd          , Aa          
Ww          , Aa          , Aa          , Aa          , Aa          , Aa          , Aa          , Rd          , Rd          , Hd          , Hd          , Chw         , Chw         , Chw         , Hd          , Hd          , Rd          , Rd          , Aa          , Aa          
Xu          , Ww          , Ww          , Aa          , Aa          , Ha          , Ha          , Aa          , Aa          , Rd          , Rd          , Hd          , Hd          , Hd          , Rd          , Rd          , Aa          , Aa          , Ha^Fpa      , Ha^Fpa      
Ha          , Xu          , Aa          , Ww          , Aa          , Ha          , Ha          , Ha          , Ha          , Aa          , Aa          , Rd          , Rd          , Rd          , Aa          , Aa          , Ha          , Ha          , Ha          , Ha^Fpa      
Ha          , Ha          , Aa          , Ww          , Aa          , Ha          , Ha          , Ha          , Ha          , Ha          , Ha          , Aa          , Aa          , Aa          , Ha          , Ha^Fpa      , Ha          , Ha          , Ha          , Ha          
Ha          , Ha          , Aa          , Ai          , Ai          , Aa          , Ha          , Ha          , Ha          , Ha          , Ha          , Aa          , Aa          , Aa          , Ha          , Ha          , Ha          , Ha          , Ha          , Ha          
Ha          , Ha          , Aa          , Aa          , Ai          , Aa          , Ha          , Ha          , Ha          , Ha          , Ha          , Aa          , Aa          , Aa          , Ha          , Ha          , Ha          , Ha^Fpa      , Ha          , Ha          
Ha          , Ha          , Aa          , Ai          , Aa          , Aa          , Ha          , Ha          , Ha          , Ha          , Ha          , Aa          , 1 Aa        , Aa          , Ha          , Ha          , Ha          , Ha          , Ha          , Ha          
Aa          , Aa          , Ai          , Ai          , Aa          , Ha          , Ha          , Ha          , Ha          , Ha          , Ha          , Aa          , Aa          , Aa          , Ha          , Ha          , Ha          , Ha          , Ha          , Ha          
Ai          , Ai          , Ww          , Aa          , Aa          , Ha          , Ha          , Ha          , Ha          , Ha          , Ms          , Ha          , Ms          , Aa          , Ms          , Ha          , Ms          , Ha          , Ms          , Ha          
Ww          , Ww          , Aa          , Aa          , Aa          , Aa          , Aa          , Ms          , Ms          , Ms          , Ms          , Ms          , Ms          , Ms          , Ms          , Ms          , Ms          , Ms          , Ms          , Ms          
Ms          , Aa          , Ms          , Aa          , Ms          , Aa          , Ms          , Ms          , Ms          , Ms          , Ms          , Ms          , Ms          , Ms          , Ms          , Ms          , Ms          , Ms          , Ms          , Ms          
