border_size=1
usage=map

Wo          , Wo          , Wo          , Wo          , Wo          , Xu          , Xu          , Xu          , Xu          , Xu          , Xos         , Xu          , Xu          , Xu          , Xos         , Xos         , Xos         , Xu          , Xos         , Xos         , Xos         , Xu          , Xu          , Xu          , Xu          , Xu          , Xu          , Xu          , Xu          , Xu          , Xu          , Xu          , Xu          , Xu          , Xu          , Xu          , Xu          , Xu          , Xu          , Xu          , Xos         , Xu          , Xu          , Xu          , Xu          , Xu          
Wo          , Wo          , Wo          , Wo          , Wo          , Wo          , Wo          , Xu          , Xos         , Xos         , Rr          , Xos         , Xos         , Xos         , Rr          , Xu          , Rr          , Xos         , Rr          , Rp^Vhc      , Rr          , Xos         , Xos         , Xu          , Xu          , Xu          , Xu          , Xu          , Xu          , Xu          , Xu          , Xu          , Xu          , Xu          , Xos         , Xu          , Xos         , Xu          , Xos         , Xos         , Rr          , Xos         , Xos         , Xu          , Xu          , Xu          
Wo          , Wo          , Wo^Bw|      , Wo          , Wo          , Wo          , Wo          , Wo^Bw\      , Rr          , Rr          , Rp^Vhc      , Rr          , Rr          , Rr          , Rp^Vhc      , Rr          , Rr          , Rr          , Rr          , Rr          , Rr          , Rp^Vhc      , Rr          , Xos         , Xos         , Xos         , Xos         , Xu          , Xu          , Xu          , Rr          , Xu          , Rr          , Rr          , Rr          , Xos         , Xos         , Xos         , Rr          , Rr          , Xos         , Rr          , Rr          , Xos         , Xos         , Xu          
Wo          , Xu          , Rr          , Wo          , Wo^Bw|      , Wo          , Wo^Bw\      , Wo          , Rr          , Rr          , Rr          , Rr          , Rp^Vhc      , Rr          , Rr          , Rr          , Rr          , Rr          , Rr          , Xos         , Rr          , Rr          , Rr          , Rp^Vhc      , Rr          , Cud         , Rr          , Rr          , Rr          , Rr          , Rr          , Rr          , Rr          , Rr          , Rr          , Rr          , Xos         , Rr          , Xos         , Xos         , Xos         , Rr          , Wwf         , Wwf         , Xos         , Xu          
Wo          , Xu          , Xos         , Rr          , Rr          , Wo          , Rr          , Rp^Vhc      , Rr          , Rr          , Rp^Vhc      , Rr          , Rr          , Rr          , Rp^Vhc      , Rr          , Rr          , Rr          , Rr          , Rr          , Rr          , Rr          , Rr          , Rr          , Rr          , Cud         , Rr          , Rr          , Rr          , Rr          , Rr          , Rr          , Rr          , Rr          , Xos         , Xos         , Xu          , Xos         , Xu          , Xu          , Xu          , Xos         , Xos         , Xos         , Xu          , Xu          
Wo          , Xu          , Xu          , Xos         , Xos         , Rr          , Xos         , Rr          , Rr          , Rr          , Rr          , Rr          , Rr          , Rr          , Rr          , Xos         , Rr          , Rr          , Rr          , Xos         , Rr          , Rr          , Rr          , Rr          , Cud         , 5 Kud       , Cud         , Rr          , Xu          , Xu          , Xu          , Xu          , Xu          , Rr          , Xu          , Xu          , Xu          , Xu          , Xu          , Xu          , Xu          , Xu          , Xu          , Xu          , Xu          , Xu          
Wo          , Xu          , Xu          , Xu          , Xu          , Xos         , Xu          , Xos         , Xos         , Rr          , Xos         , Xos         , Xos         , Rr          , Xos         , Rr          , Xos         , Rr          , Xos         , Rr          , Rr          , Rr          , Rr          , Rr          , Cud         , Rr          , Cud         , Xos         , Xu          , Xu          , Xu          , Xu          , Xu          , Xu          , Xu          , Xu          , Xu          , Xu          , Xu          , Xu          , Xu          , Xu          , Xu          , Xu          , Xu          , Xu          
Xu          , Ww          , Ww          , Xu          , Xu          , Xu          , Xu          , Xu          , Xu          , Xos         , Xu          , Xu          , Xu          , Xos         , Xos         , Xos         , Xu          , Xos         , Xu          , Xos         , Xos         , Xos         , Xos         , Xos         , Ur          , Cud         , Ur          , Xos         , Uh          , Xu          , Xu          , Xu          , Xu          , Xu          , Xu          , Xu          , Xu          , Xu          , Xu          , Xu          , Xu          , Xu          , Xu          , Xu          , Xu          , Xu          
Xu          , Xu          , Wwf         , Wwf         , Wwf         , Xu          , Uu^Uf       , Xu          , Xu          , Xu          , Xu          , Xu          , Xu          , Xu          , Xu          , Xos         , Xos         , Xu          , Xu          , Xu          , Xu          , Xu          , Xu          , Xos         , Ur          , Ur          , Ur          , Xos         , Qxu         , Qxu         , Xu          , Xu          , Xu          , Xu          , Xu          , Xu          , Xu          , Xu          , Xu          , Xu          , Xu          , Xu          , Xu          , Xu          , Xu          , Xu          
Xu          , Xu          , Uu^Uf       , Wwf         , Wwf         , Wwf         , Wwf         , Xu          , Xu          , Xu          , Xu          , Xu          , Xu          , Xu          , Xu          , Xu          , Xu          , Xu          , Xu          , Xu          , Xu          , Xu          , Xu          , Xos         , Xos         , Ur          , Qxu^Bs\     , Qxu^Bs\     , Ur          , Xu          , Xu          , Xu          , Xu          , Xu          , Xu          , Xu          , Xu          , Xu          , Ur          , Xu          , Ur          , Xu          , Xu          , Xu          , Xu          , Xu          
Xu          , Xu          , Xu          , Xu          , Uu^Uf       , Wwf         , Uu^Uf       , Xu          , Xu          , Xu          , Xu          , Xu          , Xu          , Xu          , Xu          , Xu          , Xu          , Xu          , Xu          , Xu          , Xu          , Xu          , Xu          , Xu          , Uh          , Qxu         , Ur          , Ur          , Ur          , Ur          , Ur          , Ur          , Ur          , Ur          , Ur          , Xu          , Ur          , Ur          , Ur          , Ur          , Ur          , Ur          , Ur          , Xu          , Xu          , Xu          
Xu          , Xu          , Xu          , Uu^Uf       , Xu          , Wwf         , Uu^Uf       , Uu^Uf       , Xu          , Xu          , Xu          , Xu          , Xu          , Xu          , Xu          , Xu          , Uu          , Xu          , Xu          , Xu          , Xu          , Xu          , Xu          , Xu          , Xu          , Xu          , Uu          , Ur          , Ur          , Ur          , Uu          , Xu          , Uu          , Xu          , Uu          , Ur          , Uu          , Xu          , Xu          , Ur          , Xu          , Ur          , Xu          , Ur          , Xu          , Xu          
Xu          , Xu          , Xu          , Xu          , Uu^Uf       , Wwf         , Xu          , Xu          , Xu          , Xu          , Xu          , Xu          , Xu          , Uu^Vud      , Uu          , Uu          , Xu          , Uu          , Xu          , Xu          , Xu          , Xu          , Xu          , Xu          , Uu          , Uu          , Ur          , Ur          , Xu          , Xu          , Xu          , Uu          , Xu          , Uu          , Xu          , Xu          , Xu          , Uu          , Uu          , Ur          , Uu          , Uu          , Ur          , Ur          , Xu          , Xu          
Xu          , Xu          , Xu          , Xu          , Uu^Uf       , Wwf         , Uu^Uf       , Xu          , Xu          , Xu          , Xu          , Xu          , Xu          , Uu          , Xu          , Uu          , Uu          , Uu          , Uu^Vud      , Xu          , Xu          , Xu          , Xu          , Uu          , 4 Kud       , Ur          , Ur          , Ur          , Xu          , Xu          , Xu          , Xu          , Xu          , Xu          , Xu          , Xu          , Xu          , Xu          , Uu          , Ur          , Ur          , Ur          , Xu          , Xu          , Xu          , Xu          
Xu          , Xu          , Xu          , Xu          , Xu          , Wwf         , Wwf         , Xu          , Uu^Uf       , Xu          , Uu^Uf       , Xu          , Xu          , Uu          , Uu^Uf       , Uu^Vud      , Uu^Uf       , Uu          , Uu          , Xu          , Xu          , Xu          , Xu          , Xu          , Xu          , Cud         , Xu          , Xu          , Xu          , Xu          , Xu          , Xu          , Xu          , Xu          , Xu          , Xu          , Uu          , Uu          , Ur          , Ur          , Xu          , Xu          , Xu          , Xu          , Xu          , Xu          
Xu          , Xu          , Xu          , Xu          , Xu          , Uu^Vud      , Xu          , Wwf         , Wwf         , Xu          , Uu^Uf       , Xu          , Xu          , Xu          , Uu          , Uu          , Uu          , Xu          , Uu          , Uu          , Xu          , Xu          , Xu          , Xu          , Xu          , Xu          , Xu          , Xu          , Xu          , Xu          , Xu          , Xu          , Xu          , Xu          , Ur          , Ur          , Ur          , Ur          , Xu          , Xu          , Xu          , Xu          , Xu          , Xu          , Xu          , Xu          
Xu          , Xu          , Xu          , Xu          , Xu          , Xu          , Xu          , Uu^Uf       , Uu^Uf       , Wwf         , Uu^Uf       , Uu^Vud      , Uu^Uf       , Uu^Uf       , Uu^Uf       , Xu          , Uu          , Uu^Uf       , Xu          , Uu          , Ur          , Xu          , Xu          , Xu          , Xu          , Xu          , Ur          , Xu          , Xu          , Xu          , Ur          , Xu          , Ur          , Ur          , Ur          , Uu          , Uu          , Uu^Vud      , Xu          , Xu          , Xu          , Xu          , Xu          , Xu          , Xu          , Xu          
Xu          , Xu          , Xu          , Xu          , Uu          , Xu          , Uu          , Uu          , Uu^Uf       , Wwf         , Xu          , Uu^Uf       , Xu          , Xu          , Uu^Uf       , Uu          , Xu          , Uu          , Ur          , Ur          , Ur          , Ur          , Ur          , Xu          , Ur          , Ur          , Xu          , Ur          , Ur          , Ur          , Ur          , Ur          , Ur          , Ur          , Ur          , Ur          , Uu          , Xu          , Xu          , Xu          , Xu          , Xu          , Xu          , Xu          , Xu          , Xu          
Xu          , Xu          , Xu          , Ql          , Uu          , Uu          , Xu          , Xu          , Uu^Vud      , Wwf         , Uu^Uf       , Xu          , Xu          , Xu          , Uu^Vud      , Uu^Uf       , Ur          , Uu          , Ur          , Ur          , Xu          , Ur          , Ur          , Ur          , Ur          , Ur          , Ur          , Ur          , Ur          , Ur          , Rr          , Rr          , Rr          , Xu          , Ur          , Uu          , Uu          , Xu          , Uu          , Xu          , Xu          , Xu          , Xu          , Xu          , Uh          , Xu          
Xu          , Xu          , Xu          , Uu          , Uu          , Xu          , Xu          , Xu          , Xu          , Wwf         , Xu          , Uu^Uf       , Xu          , Xu          , Xu          , Uu          , Ur          , Ur          , Xu          , Xu          , Xu          , Xu          , Xu          , Ur          , Xu          , Ur          , Xu          , Xu          , Rr          , Rr          , Rr          , Rr          , Xu          , Xu          , Xu          , Ur          , Ur          , Uu          , Uu          , Uu          , Uu          , Uh          , Cud         , Uh          , Uh          , Uh          
Xu          , Xu          , Xu          , Xu          , Uu          , Uu          , Uu^Vud      , Uu^Uf       , Uu          , Wwf         , Uu^Uf       , Uu^Uf       , Xu          , Xu          , Ur          , Ur          , Xu          , Xu          , Xu          , Xu          , Xu          , Xu          , Xu          , Xu          , Xu          , Xu          , Xu          , Xu          , Rr          , Rr          , Xu          , Xu          , Xu          , Xu          , Xu          , Uu          , Uu          , Ur          , Ur          , Uu          , Uu          , Cud         , 3 Kud       , Uh          , Uh          , Uh          
Xu          , Xu          , Xu          , Xu          , Xu          , Uu          , Uu          , Uu          , Wwf         , Wwf         , Ds          , Xu          , Uu^Vud      , Xu          , Ur          , Uu          , Ur          , Uu          , Uu          , Xu          , Xu          , Xu          , Ur          , Uu^Uf       , Ur          , Xu          , Xu          , Xu          , Xu          , Xu          , Xu          , Xu          , Xu          , Xu          , Xu          , Xu          , Xu          , Uu          , Uu^Vud      , Ur          , Rr          , Rr          , Cud         , Cud         , Xu          , Xu          
Xu          , Xu          , Xu          , Xu          , Xu          , Uu^Uf       , Wwf         , Wwf         , Ur          , Ds          , Ur          , Ur          , Ur          , Ur          , Xu          , Xu          , Xu          , Xu          , Xu          , Ur          , Ur          , Ur          , Ur          , Ur          , Ur          , Ur          , Ur          , Xu          , Xu          , Xu          , Xu          , Xu          , Xu          , Xu          , Xu          , Xu          , Xu          , Xu          , Xu          , Xu          , Xu          , Uu          , Xu          , Xu          , Xu          , Xu          
Xu          , Xu          , Xu          , Xu          , Xu          , Xu          , Wwf         , Rr          , Uu^Vud      , Ur          , Ur          , Ur          , Ur          , Ur          , Ur          , Uu^Uf       , Uu          , Xu          , Ur          , Ur          , Ur          , Ur          , Ur          , Ur          , Ur          , Ur          , Ur          , Ur          , Ur          , Xu          , Xu          , Xu          , Xu          , Xu          , Xu          , Xu          , Xu          , Xu          , Xu          , Xu          , Xu          , Xu          , Xu          , Xu          , Xu          , Xu          
Xu          , Xu          , Cud         , Cud         , Cud         , Rr          , Wwf         , Rr          , Xu          , Xu          , Xu          , Ur          , Uu          , Ur          , Ur          , Ur          , Ur          , Ur          , Ur          , Ur          , Ur          , Ur          , Xu          , Xu          , Xu          , Ur          , Ur          , Ur          , Ur          , Ur          , Ur          , Xu          , Xu          , Xu          , Uu          , Xu          , Uu          , Xu          , Xu          , Xu          , Uh          , Xu          , Xu          , Xu          , Xu          , Xu          
Xu          , Xu          , Cud         , 2 Kud       , Cud         , Rr          , Wwf         , Rr          , Uu^Uf       , Xu          , Xu          , Xu          , Xu          , Uu          , Xu          , Ur          , Ds          , Ur          , Ur          , Ur          , Xu          , Xu          , Xu          , Xu          , Ur          , Ur          , Xu          , Ur          , Ur          , Ur          , Ur          , Ur          , Ur          , Ur          , Ur          , Uu          , Ur          , Uu          , Uu          , Uh          , Uu          , Uh          , Uu          , Xu          , Xu          , Xu          
Xu          , Xu          , Xu          , Cud         , Xu          , Rr          , Uu          , Wwf         , Wwf         , Uu^Uf       , Xu          , Xu          , Uu^Uf       , Xu          , Xu          , Xu          , Xu          , Xu          , Xu          , Xu          , Xu          , Uu^Uf       , Uu^Uf       , Uu^Vud      , Xu          , Xu          , Xu          , Xu          , Xu          , Ur          , Ur          , Ur          , Ur          , Ur          , Ur          , Ur          , Ur          , Ur          , Ur          , Ur          , Ur          , Ur          , Cud         , Ur          , Xu          , Xu          
Xu          , Xu          , Xu          , Xu          , Xu          , Xu          , Uu^Vud      , Uu          , Uu^Uf       , Wwf         , Wwf         , Xu          , Uu^Uf       , Xu          , Xu          , Xu          , Xu          , Xu          , Xu          , Xu          , Xu          , Xu          , Xu          , Xu          , Xu          , Xu          , Xu          , Xu          , Xu          , Xu          , Xu          , Xu          , Xu          , Ur          , Uu          , Ur          , Uu          , Ur          , Ur          , Ur          , Ur          , Cud         , 1 Kud       , Cud         , Ur          , Xu          
Xu          , Xu          , Xu          , Xu          , Xu          , Xu          , Xu          , Xu          , Xu          , Uu          , Xu          , Wwf         , Wwf         , Xu          , Xu          , Xu          , Xu          , Xu          , Xu          , Xu          , Xu          , Xu          , Xu          , Xu          , Xu          , Xu          , Xu          , Xu          , Xu          , Xu          , Xu          , Xu          , Xu          , Xu          , Xu          , Uu          , Xu          , Xu          , Xu          , Ur          , Xu          , Cud         , Cud         , Cud         , Ur          , Ur          
Xu          , Xu          , Xu          , Xu          , Xu          , Xu          , Xu          , Xu          , Xu          , Xu          , Xu          , Xu          , Xu          , Wwf         , Xu          , Xu          , Xu          , Xu          , Xu          , Xu          , Xu          , Xu          , Xu          , Xu          , Xu          , Xu          , Xu          , Xu          , Xu          , Xu          , Xu          , Xu          , Xu          , Xu          , Xu          , Xu          , Xu          , Xu          , Xu          , Xu          , Xu          , Xu          , Xu          , Ur          , Ur          , Ur          
